date,province,region,ratio_tourist_stay,no_tourist_stay,no_tourist_all,no_tourist_thai,no_tourist_foreign,revenue_all,revenue_thai,revenue_foreign
2019-01-01,Bangkok,central,0.9337000000000001,3334971,5959075,3534061,2425014,81926490000,29742580000,52183910000
2019-01-01,Lopburi ,central,0.6132,51858,268664,266301,2363,457240000,451830000,5410000
2019-01-01,Phra Nakhon Si Ayutthaya ,central,0.7337,117052,730329,561553,168776,1438730000,1054250000,384480000
2019-01-01,Saraburi ,central,0.6733,89850,207236,201400,5836,347790000,336190000,11600000
2019-01-01,Chainat ,central,0.7931,27141,79073,78514,559,101790000,100900000,890000
2019-01-01,Nakhon Pathom ,central,0.7170000000000001,118629,296107,284408,11699,407980000,391120000,16860000
2019-01-01,Sing Buri ,central,0.6465000000000001,18147,49438,49190,248,69610000,69220000,390000
2019-01-01,Ang Thong ,central,0.7121,19140,104097,98816,5281,132070000,126320000,5750000
2019-01-01,Nonthaburi ,central,0.7506999999999999,100553,323717,293344,30373,527420000,422330000,105090000
2019-01-01,Pathum Thani ,central,0.6077,56118,233295,172417,60878,307920000,204140000,103780000
2019-01-01,Samut Prakan ,central,0.725,109185,408652,199324,209328,796190000,308330000,487860000
2019-01-01,Samut Sakhon ,central,0.6164000000000001,56561,109253,108832,421,164490000,163760000,730000
2019-01-01,Chachoengsao ,east,0.594,38687,270438,266707,3731,292960000,288180000,4780000
2019-01-01,Ratchaburi ,central,0.7509,93978,236440,231887,4553,450010000,439180000,10830000
2019-01-01,Kanchanaburi ,central,0.838,339491,752901,707690,45211,2695150000,2438190000,256960000
2019-01-01,Samut Songkhram ,central,0.7559999999999999,65407,201751,197952,3799,344930000,337590000,7340000
2019-01-01,Suphan Buri ,central,0.8943000000000001,99531,235981,234233,1748,487610000,484900000,2710000
2019-01-01,Phetchaburi ,central,0.812,357725,713674,643367,70307,2352550000,1776560000,575990000
2019-01-01,Prachuap Khiri Khan ,central,0.6455,391494,639052,511080,127972,3755100000,2516840000,1238260000
2019-01-01,Chonburi ,east,0.8432999999999999,1343262,1570327,632916,937411,27896450000,3967440000,23929010000
2019-01-01,Chanthaburi ,east,0.6886,118776,257105,250149,6956,844480000,795710000,48770000
2019-01-01,Trat ,east,0.8048000000000001,205330,224218,142674,81544,2073220000,900150000,1173070000
2019-01-01,Nakhon Nayok ,east,0.6839,140711,278705,276249,2456,842490000,836200000,6290000
2019-01-01,Prachinburi ,east,0.6857,106063,183846,170721,13125,521290000,479400000,41890000
2019-01-01,Rayong ,east,0.7011,377300,650811,581623,69188,2435410000,1980420000,454990000
2019-01-01,Sa Kaeo ,east,0.5669,69400,199751,165131,34620,581600000,483690000,97910000
2019-01-01,Phuket ,south,0.8604999999999999,1528585,1690776,357769,1333007,55328200000,4770590000,50557610000
2019-01-01,Phatthalung ,south,0.6866,67285,120318,119521,797,181320000,178810000,2510000
2019-01-01,Trang ,south,0.723,131744,173715,149399,24316,1250160000,1029670000,220490000
2019-01-01,Ranong ,south,0.5932999999999999,85886,110844,103790,7054,368380000,322820000,45560000
2019-01-01,Chumphon ,south,0.6194,92831,116543,105960,10583,496860000,447370000,49490000
2019-01-01,Pattani ,south,0.7847,18105,22499,22345,154,79150000,78470000,680000
2019-01-01,Yala ,south,0.5253,49144,52984,9567,43417,236370000,37040000,199330000
2019-01-01,Nakhon Si Thammarat ,south,0.5984,245874,384120,373158,10962,1270860000,1235490000,35370000
2019-01-01,Narathiwat ,south,0.6395000000000001,53863,66654,24265,42389,246030000,63950000,182080000
2019-01-01,Krabi ,south,0.8162,348964,564380,185557,378823,10844790000,2989400000,7855390000
2019-01-01,Songkhla ,south,0.7484999999999999,431256,774786,532223,242563,6531350000,3605370000,2925980000
2019-01-01,Phang Nga ,south,0.8651000000000001,128033,536274,151483,384791,6062060000,929750000,5132310000
2019-01-01,Surat Thani ,south,0.7559,484886,540614,183500,357114,9795400000,1285970000,8509430000
2019-01-01,Satun ,south,0.7490000000000001,88512,210906,190827,20079,1762520000,1661300000,101220000
2019-01-01,Kamphaeng Phet ,north,0.5735,45815,74421,72183,2238,156400000,149140000,7260000
2019-01-01,Chiang Rai ,north,0.8125,403624,453291,386065,67226,3204260000,2628010000,576250000
2019-01-01,Chiang Mai ,north,0.9104000000000001,928602,1173786,841830,331956,12004620000,7670670000,4333950000
2019-01-01,Phichit ,north,0.5768,46475,64359,63777,582,136240000,135340000,900000
2019-01-01,Nakhon Sawan ,north,0.6354,118061,189826,183487,6339,349650000,340970000,8680000
2019-01-01,Tak ,north,0.7698,182684,241654,236008,5646,715400000,695170000,20230000
2019-01-01,Phitsanulok ,north,0.7152,202934,387608,364864,22744,989880000,916860000,73020000
2019-01-01,Phayao ,north,0.6937000000000001,33961,80767,77299,3468,148560000,143930000,4630000
2019-01-01,Phetchabun ,north,0.7445999999999999,214329,255911,253752,2159,861900000,855940000,5960000
2019-01-01,Phrae ,north,0.6714,35764,83792,74753,9039,185370000,151750000,33620000
2019-01-01,Lampang ,north,0.7739,69285,117418,106656,10762,339280000,285760000,53520000
2019-01-01,Lamphun ,north,0.6576000000000001,27710,117882,111305,6577,185470000,172640000,12830000
2019-01-01,Mae Hong Son ,north,0.7792,137937,146468,113044,33424,672080000,421090000,250990000
2019-01-01,Uttaradit ,north,0.6256,65695,125154,124175,979,253400000,251190000,2210000
2019-01-01,Uthai Thani ,north,0.5156000000000001,30736,76665,76374,291,123830000,122840000,990000
2019-01-01,Sukhothai ,north,0.7309,89231,150621,107592,43029,348290000,206210000,142080000
2019-01-01,Nan ,north,0.8073999999999999,95902,113649,111445,2204,334100000,323320000,10780000
2019-01-01,Kalasin ,east_northeast,0.5576,23197,62141,61619,522,93880000,92720000,1160000
2019-01-01,Khon Kaen ,east_northeast,0.6731,244958,639369,631397,7972,1906050000,1881610000,24440000
2019-01-01,Chaiyaphum ,east_northeast,0.6559,72160,136109,135391,718,179160000,177360000,1800000
2019-01-01,Nakhon Phanom ,east_northeast,0.6542,46232,104305,96871,7434,220710000,210700000,10010000
2019-01-01,Nakhon Ratchasima ,east_northeast,0.7767000000000001,529946,1012772,992396,20376,2504220000,2407700000,96520000
2019-01-01,Buriram ,east_northeast,0.7126,113655,185563,180076,5487,364160000,355910000,8250000
2019-01-01,Maha Sarakham ,east_northeast,0.6185,45480,72804,70956,1848,115940000,113550000,2390000
2019-01-01,Mukdahan ,east_northeast,0.6966,70953,218485,203920,14565,386620000,354150000,32470000
2019-01-01,Roi Et ,east_northeast,0.6027,43424,84761,83928,833,116210000,114430000,1780000
2019-01-01,Loei ,east_northeast,0.7817000000000001,130458,212225,209451,2774,473630000,463520000,10110000
2019-01-01,Sisaket ,south,0.6862999999999999,44457,185521,183092,2429,285020000,278840000,6180000
2019-01-01,Surin ,east_northeast,0.6137,100932,134324,130719,3605,346830000,335080000,11750000
2019-01-01,Nong Khai ,east_northeast,0.7092,118898,259265,188092,71173,546790000,446920000,99870000
2019-01-01,Bueng Kan ,east_northeast,0.7295,37974,65978,65700,278,137810000,137140000,670000
2019-01-01,Udon Thani ,east_northeast,0.7679,189778,282871,265790,17081,777600000,695870000,81730000
2019-01-01,Ubon Ratchathani ,east_northeast,0.7737,147377,316431,297757,18674,1001550000,913480000,88070000
2019-01-01,Sakon Nakhon ,east_northeast,0.6469,66034,116238,115844,394,240630000,239410000,1220000
2019-01-01,Yasothon ,east_northeast,0.6363,17237,59234,57363,1871,76950000,72890000,4060000
2019-01-01,Amnat Charoen ,east_northeast,0.6515000000000001,8551,21790,20972,818,34510000,32640000,1870000
2019-01-01,Nong Bua Lamphu ,east_northeast,0.6505,14081,36343,36182,161,38490000,38250000,240000
2019-02-01,Bangkok,central,0.8919,3025538,5211404,2919922,2291482,73884430000,24574000000,49310430000
2019-02-01,Lopburi ,central,0.6281,49385,256248,254213,2035,435980000,431320000,4660000
2019-02-01,Phra Nakhon Si Ayutthaya ,central,0.726,101718,641959,458781,183178,1278600000,861310000,417290000
2019-02-01,Saraburi ,central,0.6638,77528,178813,173772,5041,300090000,290070000,10020000
2019-02-01,Chainat ,central,0.7715000000000001,25861,75380,74931,449,97010000,96300000,710000
2019-02-01,Nakhon Pathom ,central,0.7039,107577,270865,256099,14766,373470000,352190000,21280000
2019-02-01,Sing Buri ,central,0.6670999999999999,18434,50208,50036,172,70680000,70410000,270000
2019-02-01,Ang Thong ,central,0.7254,17409,93944,90029,3915,119340000,115080000,4260000
2019-02-01,Nonthaburi ,central,0.7415,88147,289465,266214,23251,463720000,383270000,80450000
2019-02-01,Pathum Thani ,central,0.5736,47402,196891,148869,48022,258130000,176260000,81870000
2019-02-01,Samut Prakan ,central,0.7155,102523,383666,180698,202968,752560000,279520000,473040000
2019-02-01,Samut Sakhon ,central,0.6465000000000001,57331,110685,110380,305,166620000,166090000,530000
2019-02-01,Chachoengsao ,east,0.6502,36670,256405,252608,3797,277810000,272950000,4860000
2019-02-01,Ratchaburi ,central,0.6073,65904,166585,161847,4738,317800000,306530000,11270000
2019-02-01,Kanchanaburi ,central,0.7513,315790,701199,655526,45673,2518060000,2258470000,259590000
2019-02-01,Samut Songkhram ,central,0.7044,60077,185309,181775,3534,316830000,310000000,6830000
2019-02-01,Suphan Buri ,central,0.9048,91004,215765,214166,1599,445830000,443350000,2480000
2019-02-01,Phetchaburi ,central,0.7728,358668,715611,645197,70414,2358480000,1781620000,576860000
2019-02-01,Prachuap Khiri Khan ,central,0.5286,345890,563718,448291,115427,3324500000,2207630000,1116870000
2019-02-01,Chonburi ,east,0.8785,1271425,1511239,686630,824609,25353710000,4304150000,21049560000
2019-02-01,Chanthaburi ,east,0.6537999999999999,101232,219047,212941,6106,720170000,677350000,42820000
2019-02-01,Trat ,east,0.8258,198785,217190,142010,75180,1977490000,895960000,1081530000
2019-02-01,Nakhon Nayok ,east,0.6142,126643,251091,248393,2698,758790000,751880000,6910000
2019-02-01,Prachinburi ,east,0.6461,91717,159020,147822,11198,450840000,415100000,35740000
2019-02-01,Rayong ,east,0.7323000000000001,377905,651157,585709,65448,2424730000,1994330000,430400000
2019-02-01,Sa Kaeo ,east,0.617,71344,201364,172438,28926,586900000,505090000,81810000
2019-02-01,Phuket ,south,0.8637999999999999,1370156,1522828,501114,1021714,45433040000,6681990000,38751050000
2019-02-01,Phatthalung ,south,0.713,67001,119842,119150,692,180430000,178250000,2180000
2019-02-01,Trang ,south,0.8456,138665,182852,157529,25323,1315320000,1085700000,229620000
2019-02-01,Ranong ,south,0.675,87811,113355,106278,7077,376270000,330560000,45710000
2019-02-01,Chumphon ,south,0.6459,90836,113700,105149,8551,483920000,443940000,39980000
2019-02-01,Pattani ,south,0.7958,18467,22939,22661,278,80810000,79580000,1230000
2019-02-01,Yala ,south,0.5034000000000001,49200,53188,11355,41833,236030000,43970000,192060000
2019-02-01,Nakhon Si Thammarat ,south,0.6419,201458,315268,305351,9917,1042980000,1010990000,31990000
2019-02-01,Narathiwat ,south,0.8833,55708,69325,33515,35810,242150000,88330000,153820000
2019-02-01,Krabi ,south,0.8472,457421,730767,324352,406415,13653020000,5225450000,8427570000
2019-02-01,Songkhla ,south,0.7154,379226,667961,442475,225486,5717390000,2997400000,2719990000
2019-02-01,Phang Nga ,south,0.8031999999999999,116365,494610,114972,379638,5769250000,705660000,5063590000
2019-02-01,Surat Thani ,south,0.7658,468127,525305,211213,314092,8964450000,1480180000,7484270000
2019-02-01,Satun ,south,0.7848999999999999,78130,186195,168514,17681,1556180000,1467050000,89130000
2019-02-01,Kamphaeng Phet ,north,0.5164,37426,60912,58802,2110,128330000,121490000,6840000
2019-02-01,Chiang Rai ,north,0.7258,336276,378751,315115,63636,2690520000,2145040000,545480000
2019-02-01,Chiang Mai ,north,0.8549,804684,1013231,710384,302847,10426860000,6472950000,3953910000
2019-02-01,Phichit ,north,0.5546,42406,58683,58207,476,124260000,123520000,740000
2019-02-01,Nakhon Sawan ,north,0.6420999999999999,111345,179864,172688,7176,330720000,320900000,9820000
2019-02-01,Tak ,north,0.7258,160346,212104,207150,4954,627910000,610160000,17750000
2019-02-01,Phitsanulok ,north,0.6637000000000001,177202,338067,316689,21378,864440000,795800000,68640000
2019-02-01,Phayao ,north,0.6175,26710,63598,60787,2811,116940000,113190000,3750000
2019-02-01,Phetchabun ,north,0.6307,168561,201362,199520,1842,678100000,673010000,5090000
2019-02-01,Phrae ,north,0.6143,30830,72443,63682,8761,161870000,129280000,32590000
2019-02-01,Lampang ,north,0.6704000000000001,55196,92910,82734,10176,272280000,221670000,50610000
2019-02-01,Lamphun ,north,0.5851,21764,92594,87376,5218,145700000,135520000,10180000
2019-02-01,Mae Hong Son ,north,0.7295999999999999,118024,125322,96203,29119,577020000,358360000,218660000
2019-02-01,Uttaradit ,north,0.5609000000000001,53634,102191,101296,895,206930000,204910000,2020000
2019-02-01,Uthai Thani ,north,0.5437,29469,73520,73263,257,118710000,117840000,870000
2019-02-01,Sukhothai ,north,0.6481,73675,124865,82785,42080,297610000,158660000,138950000
2019-02-01,Nan ,north,0.7258,80087,94966,92426,2540,280560000,268140000,12420000
2019-02-01,Kalasin ,east_northeast,0.5578,19801,53039,52612,427,80110000,79160000,950000
2019-02-01,Khon Kaen ,east_northeast,0.5251,180982,472270,466030,6240,1407930000,1388800000,19130000
2019-02-01,Chaiyaphum ,east_northeast,0.5418999999999999,52842,99661,99109,552,131210000,129830000,1380000
2019-02-01,Nakhon Phanom ,east_northeast,0.6467,46194,101998,97019,4979,217720000,211020000,6700000
2019-02-01,Nakhon Ratchasima ,east_northeast,0.7462000000000001,427535,815885,794945,20940,2027850000,1928660000,99190000
2019-02-01,Buriram ,east_northeast,0.636,95097,154626,151091,3535,303930000,298620000,5310000
2019-02-01,Maha Sarakham ,east_northeast,0.5865,36786,58831,57595,1236,93770000,92170000,1600000
2019-02-01,Mukdahan ,east_northeast,0.6278,61872,190022,177964,12058,335950000,309070000,26880000
2019-02-01,Roi Et ,east_northeast,0.5535,38814,75750,75073,677,103810000,102360000,1450000
2019-02-01,Loei ,east_northeast,0.7097,110112,179124,177100,2024,399310000,391930000,7380000
2019-02-01,Sisaket ,south,0.6424,39741,166017,164036,1981,254860000,249820000,5040000
2019-02-01,Surin ,east_northeast,0.6039,82398,109658,106720,2938,283140000,273560000,9580000
2019-02-01,Nong Khai ,east_northeast,0.6625,96539,213038,152435,60603,447240000,362200000,85040000
2019-02-01,Bueng Kan ,east_northeast,0.6158,29858,51880,51680,200,108360000,107880000,480000
2019-02-01,Udon Thani ,east_northeast,0.8304,186773,278140,261969,16171,763240000,685860000,77380000
2019-02-01,Ubon Ratchathani ,east_northeast,0.6981,118871,255068,238907,16161,809160000,732940000,76220000
2019-02-01,Sakon Nakhon ,east_northeast,0.583,55937,98469,98177,292,203800000,202900000,900000
2019-02-01,Yasothon ,east_northeast,0.6091,14597,50196,48663,1533,65160000,61830000,3330000
2019-02-01,Amnat Charoen ,east_northeast,0.633,8001,20377,19597,780,32290000,30500000,1790000
2019-02-01,Nong Bua Lamphu ,east_northeast,0.6107,14116,36424,36279,145,38560000,38350000,210000
2019-03-01,Bangkok,central,0.8440000000000001,2887616,5185040,3097209,2087831,70994130000,26066060000,44928070000
2019-03-01,Lopburi ,central,0.5637,49165,255516,253713,1803,434570000,430450000,4120000
2019-03-01,Phra Nakhon Si Ayutthaya ,central,0.6883,107843,673327,515553,157774,1327300000,967880000,359420000
2019-03-01,Saraburi ,central,0.6439,83226,192040,187080,4960,322140000,312280000,9860000
2019-03-01,Chainat ,central,0.7855,27089,79017,78677,340,101680000,101120000,560000
2019-03-01,Nakhon Pathom ,central,0.6892,110746,276857,265179,11678,381500000,364670000,16830000
2019-03-01,Sing Buri ,central,0.6464,19292,52548,52351,197,74010000,73690000,320000
2019-03-01,Ang Thong ,central,0.7238,18721,101423,96733,4690,128750000,123630000,5120000
2019-03-01,Nonthaburi ,central,0.6751999999999999,87512,288068,265391,22677,460560000,382100000,78460000
2019-03-01,Pathum Thani ,central,0.5770000000000001,50810,211911,143036,68875,286760000,169350000,117410000
2019-03-01,Samut Prakan ,central,0.6725,109200,408778,208065,200713,789600000,321840000,467760000
2019-03-01,Samut Sakhon ,central,0.6111,56681,109452,109104,348,164790000,164190000,600000
2019-03-01,Chachoengsao ,east,0.6015,38242,267162,264115,3047,289300000,285400000,3900000
2019-03-01,Ratchaburi ,central,0.5776,58254,147825,142494,5331,282560000,269880000,12680000
2019-03-01,Kanchanaburi ,central,0.6529,295348,657920,606312,51608,2382220000,2088920000,293300000
2019-03-01,Samut Songkhram ,central,0.6437,57907,178616,175054,3562,305430000,298540000,6890000
2019-03-01,Suphan Buri ,central,0.8462999999999999,92857,220179,218694,1485,455060000,452740000,2320000
2019-03-01,Phetchaburi ,central,0.7165,317757,640189,586711,53478,2058250000,1620130000,438120000
2019-03-01,Prachuap Khiri Khan ,central,0.6158,364411,603965,509005,94960,3425440000,2506600000,918840000
2019-03-01,Chonburi ,east,0.8172,1310969,1560331,715337,844994,25984460000,4484120000,21500340000
2019-03-01,Chanthaburi ,east,0.7056999999999999,120696,261843,256045,5798,855130000,814470000,40660000
2019-03-01,Trat ,east,0.7872,203275,222080,144734,77346,2024070000,913140000,1110930000
2019-03-01,Nakhon Nayok ,east,0.6209,137325,271686,269899,1787,821540000,816970000,4570000
2019-03-01,Prachinburi ,east,0.65,92481,161188,153117,8071,455720000,429970000,25750000
2019-03-01,Rayong ,east,0.7354,389729,670764,607490,63274,2484600000,2068490000,416110000
2019-03-01,Sa Kaeo ,east,0.5650999999999999,73040,204831,177430,27401,597230000,519720000,77510000
2019-03-01,Phuket ,south,0.8551000000000001,1483133,1645784,477869,1167915,50668130000,6372030000,44296100000
2019-03-01,Phatthalung ,south,0.7336,71762,128439,127955,484,192980000,191440000,1540000
2019-03-01,Trang ,south,0.8181,134273,177201,156329,20872,1266700000,1077420000,189280000
2019-03-01,Ranong ,south,0.6755,94522,122332,116378,5954,400440000,361970000,38470000
2019-03-01,Chumphon ,south,0.6747,96986,121596,111412,10184,518020000,470390000,47630000
2019-03-01,Pattani ,south,0.8651000000000001,19957,24801,24636,165,87240000,86510000,730000
2019-03-01,Yala ,south,0.5473,46601,50066,6902,43164,224890000,26730000,198160000
2019-03-01,Nakhon Si Thammarat ,south,0.5896,221618,348245,334851,13394,1151870000,1108650000,43220000
2019-03-01,Narathiwat ,south,0.7775,58297,72289,29489,42800,261580000,77750000,183830000
2019-03-01,Krabi ,south,0.8089,418573,669491,289707,379784,12542640000,4667300000,7875340000
2019-03-01,Songkhla ,south,0.7634000000000001,394974,677099,425270,251829,5918620000,2880870000,3037750000
2019-03-01,Phang Nga ,south,0.8114,118568,502808,120821,381987,5836420000,741540000,5094880000
2019-03-01,Surat Thani ,south,0.7656999999999999,481231,535019,166757,368262,9943660000,1168640000,8775020000
2019-03-01,Satun ,south,0.8133,92118,220122,200167,19955,1843210000,1742620000,100590000
2019-03-01,Kamphaeng Phet ,north,0.5336,40635,65938,64117,1821,138360000,132460000,5900000
2019-03-01,Chiang Rai ,north,0.4832,258746,291144,244163,46981,2064800000,1662080000,402720000
2019-03-01,Chiang Mai ,north,0.6576000000000001,683748,847850,539723,308127,8940770000,4917910000,4022860000
2019-03-01,Phichit ,north,0.5385,43894,60809,60226,583,128700000,127800000,900000
2019-03-01,Nakhon Sawan ,north,0.5586,103725,167406,160932,6474,307970000,299080000,8890000
2019-03-01,Tak ,north,0.6676000000000001,156454,207002,202064,4938,612900000,595200000,17700000
2019-03-01,Phitsanulok ,north,0.5956,168752,321948,301590,20358,823220000,757850000,65370000
2019-03-01,Phayao ,north,0.4739,23848,57196,54227,2969,104920000,100970000,3950000
2019-03-01,Phetchabun ,north,0.5645,159094,190261,188218,2043,640540000,634880000,5660000
2019-03-01,Phrae ,north,0.5495,29944,70016,63087,6929,153860000,128070000,25790000
2019-03-01,Lampang ,north,0.6289,55552,94141,85501,8640,272040000,229080000,42960000
2019-03-01,Lamphun ,north,0.5714,23632,100441,95670,4771,157680000,148380000,9300000
2019-03-01,Mae Hong Son ,north,0.45380000000000004,85512,90795,68198,22597,424600000,254040000,170560000
2019-03-01,Uttaradit ,north,0.5825,59918,114129,113369,760,231040000,229340000,1700000
2019-03-01,Uthai Thani ,north,0.5189,30117,75114,74818,296,121340000,120340000,1000000
2019-03-01,Sukhothai ,north,0.6258,75864,128216,89557,38659,299310000,171650000,127660000
2019-03-01,Nan ,north,0.6314,76875,91125,89069,2056,268470000,258410000,10060000
2019-03-01,Kalasin ,east_northeast,0.5535,22860,61179,60908,271,92250000,91650000,600000
2019-03-01,Khon Kaen ,east_northeast,0.6202000000000001,226450,591186,584203,6983,1762340000,1740960000,21380000
2019-03-01,Chaiyaphum ,east_northeast,0.5632,57589,108648,108133,515,142940000,141650000,1290000
2019-03-01,Nakhon Phanom ,east_northeast,0.5519,41726,92322,87615,4707,196910000,190570000,6340000
2019-03-01,Nakhon Ratchasima ,east_northeast,0.6589,436561,833010,811254,21756,2071230000,1968210000,103020000
2019-03-01,Buriram ,east_northeast,0.6640999999999999,111294,181050,176767,4283,355840000,349380000,6460000
2019-03-01,Maha Sarakham ,east_northeast,0.5624,40304,64393,63334,1059,102690000,101330000,1360000
2019-03-01,Mukdahan ,east_northeast,0.5907,65556,201604,188483,13121,356580000,327340000,29240000
2019-03-01,Roi Et ,east_northeast,0.5390999999999999,33357,65132,64365,767,89370000,87740000,1630000
2019-03-01,Loei ,east_northeast,0.5945,104187,169486,167525,1961,377880000,370730000,7150000
2019-03-01,Sisaket ,south,0.6711,44457,185757,183586,2171,285150000,279620000,5530000
2019-03-01,Surin ,east_northeast,0.5947,92390,122983,119996,2987,317320000,307600000,9720000
2019-03-01,Nong Khai ,east_northeast,0.6355,96921,208054,153697,54357,441470000,365190000,76280000
2019-03-01,Bueng Kan ,east_northeast,0.5683,33727,58605,58402,203,122420000,121930000,490000
2019-03-01,Udon Thani ,east_northeast,0.7685,188534,280738,264479,16259,770240000,692420000,77820000
2019-03-01,Ubon Ratchathani ,east_northeast,0.6627,131115,281623,265775,15848,890100000,815350000,74750000
2019-03-01,Sakon Nakhon ,east_northeast,0.5284,58042,102171,101852,319,211480000,210480000,1000000
2019-03-01,Yasothon ,east_northeast,0.5878,15786,54505,53156,1349,70430000,67530000,2900000
2019-03-01,Amnat Charoen ,east_northeast,0.6607,9658,24786,24093,693,39070000,37490000,1580000
2019-03-01,Nong Bua Lamphu ,east_northeast,0.5495,13115,33814,33731,83,35770000,35650000,120000
2019-04-01,Bangkok,central,0.8791,3239883,5668049,3345739,2322310,88785900000,31928730000,56857170000
2019-04-01,Lopburi ,central,0.5364,46665,195670,194299,1371,368080000,364110000,3970000
2019-04-01,Phra Nakhon Si Ayutthaya ,central,0.6334000000000001,91330,704365,516440,187925,1965750000,1257590000,708160000
2019-04-01,Saraburi ,central,0.5531,68198,330301,325847,4454,484450000,476660000,7790000
2019-04-01,Chainat ,central,0.7755,26723,88365,87972,393,139770000,138950000,820000
2019-04-01,Nakhon Pathom ,central,0.7304999999999999,112319,281445,271588,9857,403280000,386540000,16740000
2019-04-01,Sing Buri ,central,0.6613,17297,73225,72844,381,86000000,85330000,670000
2019-04-01,Ang Thong ,central,0.6772,18524,62828,61929,899,82610000,81590000,1020000
2019-04-01,Nonthaburi ,central,0.6774,85135,244309,217836,26473,423830000,368290000,55540000
2019-04-01,Pathum Thani ,central,0.4962,43468,156063,111623,44440,298210000,158230000,139980000
2019-04-01,Samut Prakan ,central,0.6642,100981,307569,230156,77413,566500000,357460000,209040000
2019-04-01,Samut Sakhon ,central,0.6331,62191,89561,89280,281,162480000,161840000,640000
2019-04-01,Chachoengsao ,east,0.6057,43541,310140,308646,1494,491160000,487720000,3440000
2019-04-01,Ratchaburi ,central,0.5848,84769,258263,252908,5355,440250000,430310000,9940000
2019-04-01,Kanchanaburi ,central,0.6341,258308,808093,760613,47480,2156380000,1964050000,192330000
2019-04-01,Samut Songkhram ,central,0.6877,53884,150673,146052,4621,216710000,209460000,7250000
2019-04-01,Suphan Buri ,central,0.7929999999999999,90379,199163,196815,2348,422080000,415610000,6470000
2019-04-01,Phetchaburi ,central,0.7464,334555,767637,729180,38457,2571990000,2125750000,446240000
2019-04-01,Prachuap Khiri Khan ,central,0.4704,367631,560304,476932,83372,3121060000,2102200000,1018860000
2019-04-01,Chonburi ,east,0.8772,1435954,1695445,740825,954620,27090080000,4621250000,22468830000
2019-04-01,Chanthaburi ,east,0.638,159693,247957,236823,11134,978890000,901760000,77130000
2019-04-01,Trat ,east,0.7395999999999999,188320,213856,177871,35985,1795180000,1247860000,547320000
2019-04-01,Nakhon Nayok ,east,0.6049,146607,248112,247138,974,665330000,662370000,2960000
2019-04-01,Prachinburi ,east,0.5827,99003,159781,149579,10202,505790000,445850000,59940000
2019-04-01,Rayong ,east,0.8061,461325,764295,729111,35184,3113670000,2801540000,312130000
2019-04-01,Sa Kaeo ,east,0.6212,68332,192707,179247,13460,592300000,555600000,36700000
2019-04-01,Phuket ,south,0.862,1153120,1283781,341826,941955,34194850000,3878370000,30316480000
2019-04-01,Phatthalung ,south,0.6701,74472,121692,118574,3118,292980000,286000000,6980000
2019-04-01,Trang ,south,0.7831,112250,172032,157263,14769,960820000,840690000,120130000
2019-04-01,Ranong ,south,0.6973999999999999,68765,83462,78948,4514,522290000,487400000,34890000
2019-04-01,Chumphon ,south,0.7412000000000001,117864,135699,127033,8666,707770000,673500000,34270000
2019-04-01,Pattani ,south,0.6429,26659,27908,27718,190,100710000,99940000,770000
2019-04-01,Yala ,south,0.6278,59371,63823,8906,54917,330450000,28400000,302050000
2019-04-01,Nakhon Si Thammarat ,south,0.6596,250183,388286,384477,3809,2012950000,1992530000,20420000
2019-04-01,Narathiwat ,south,0.6947,65250,69519,26214,43305,363750000,122910000,240840000
2019-04-01,Krabi ,south,0.7698999999999999,387910,747326,246313,501013,9445720000,3434330000,6011390000
2019-04-01,Songkhla ,south,0.8547,526794,690002,409092,280910,6449240000,3067870000,3381370000
2019-04-01,Phang Nga ,south,0.7587,91504,469889,153801,316088,4174700000,673140000,3501560000
2019-04-01,Surat Thani ,south,0.7486,443024,489566,215083,274483,7584970000,1729780000,5855190000
2019-04-01,Satun ,south,0.7759999999999999,74855,121554,97728,23826,523500000,422450000,101050000
2019-04-01,Kamphaeng Phet ,north,0.4853,35532,67089,63919,3170,152920000,147730000,5190000
2019-04-01,Chiang Rai ,north,0.45530000000000004,226714,273208,230035,43173,2014470000,1478030000,536440000
2019-04-01,Chiang Mai ,north,0.6981999999999999,668337,763214,502969,260245,7350010000,4293020000,3056990000
2019-04-01,Phichit ,north,0.5235,30320,74718,73983,735,106610000,105150000,1460000
2019-04-01,Nakhon Sawan ,north,0.5176,80993,220447,215977,4470,458290000,449510000,8780000
2019-04-01,Tak ,north,0.6931999999999999,157460,218818,217255,1563,708050000,703080000,4970000
2019-04-01,Phitsanulok ,north,0.5722999999999999,159682,289284,276156,13128,640710000,574750000,65960000
2019-04-01,Phayao ,north,0.43560000000000004,20183,37770,36449,1321,74670000,72670000,2000000
2019-04-01,Phetchabun ,north,0.4678,155278,192232,190231,2001,588220000,580110000,8110000
2019-04-01,Phrae ,north,0.5602,25665,64759,60857,3902,123030000,111380000,11650000
2019-04-01,Lampang ,north,0.6572,53293,96071,91556,4515,309730000,287040000,22690000
2019-04-01,Lamphun ,north,0.6019,22924,96206,92078,4128,133030000,128230000,4800000
2019-04-01,Mae Hong Son ,north,0.33740000000000003,61280,68620,50061,18559,388790000,211580000,177210000
2019-04-01,Uttaradit ,north,0.5583,55792,72773,72300,473,177760000,176940000,820000
2019-04-01,Uthai Thani ,north,0.5396,31408,70487,69608,879,114270000,112400000,1870000
2019-04-01,Sukhothai ,north,0.6374,78237,138685,112092,26593,309900000,229320000,80580000
2019-04-01,Nan ,north,0.5902000000000001,56484,81699,79951,1748,271140000,264740000,6400000
2019-04-01,Kalasin ,east_northeast,0.5628,21592,52287,51811,476,102690000,101740000,950000
2019-04-01,Khon Kaen ,east_northeast,0.6175999999999999,215573,477427,469438,7989,1449710000,1402580000,47130000
2019-04-01,Chaiyaphum ,east_northeast,0.5566,65709,127842,126305,1537,161570000,159060000,2510000
2019-04-01,Nakhon Phanom ,east_northeast,0.5711999999999999,38295,101007,87766,13241,195750000,177840000,17910000
2019-04-01,Nakhon Ratchasima ,east_northeast,0.6013000000000001,452672,827070,811619,15451,1953030000,1888220000,64810000
2019-04-01,Buriram ,east_northeast,0.6509999999999999,103025,212783,208571,4212,300980000,294820000,6160000
2019-04-01,Maha Sarakham ,east_northeast,0.5207,37853,62592,61843,749,131220000,129570000,1650000
2019-04-01,Mukdahan ,east_northeast,0.5597,54188,181718,158869,22849,268000000,225840000,42160000
2019-04-01,Roi Et ,east_northeast,0.5396,36734,75338,74577,761,121700000,119980000,1720000
2019-04-01,Loei ,east_northeast,0.5713,101975,185792,182599,3193,351180000,340930000,10250000
2019-04-01,Sisaket ,south,0.5476,27120,140957,139403,1554,186400000,181600000,4800000
2019-04-01,Surin ,east_northeast,0.5506,76572,109059,107036,2023,216280000,207380000,8900000
2019-04-01,Nong Khai ,east_northeast,0.6136,91186,268297,209176,59121,530090000,449460000,80630000
2019-04-01,Bueng Kan ,east_northeast,0.5804,22547,51878,50637,1241,76730000,74470000,2260000
2019-04-01,Udon Thani ,east_northeast,0.753,188488,342905,330442,12463,938790000,881470000,57320000
2019-04-01,Ubon Ratchathani ,east_northeast,0.6435,117663,297439,282963,14476,682290000,624880000,57410000
2019-04-01,Sakon Nakhon ,east_northeast,0.5629,66677,127682,126930,752,244490000,241340000,3150000
2019-04-01,Yasothon ,east_northeast,0.6071,16258,58162,56634,1528,105100000,100550000,4550000
2019-04-01,Amnat Charoen ,east_northeast,0.5992000000000001,7762,23792,23089,703,32040000,29400000,2640000
2019-04-01,Nong Bua Lamphu ,east_northeast,0.473,10580,24004,23792,212,26730000,26450000,280000
2019-05-01,Bangkok,central,0.7944,2955553,5378757,3379718,1999039,81195510000,32253000000,48942510000
2019-05-01,Lopburi ,central,0.5111,47641,199924,198619,1305,375990000,372210000,3780000
2019-05-01,Phra Nakhon Si Ayutthaya ,central,0.6668999999999999,87841,675175,500232,174943,1877360000,1218120000,659240000
2019-05-01,Saraburi ,central,0.5397,68576,332323,328306,4017,487280000,480260000,7020000
2019-05-01,Chainat ,central,0.7492,24902,82495,82280,215,130410000,129960000,450000
2019-05-01,Nakhon Pathom ,central,0.7490000000000001,116631,291934,283526,8408,417810000,403530000,14280000
2019-05-01,Sing Buri ,central,0.5777,15365,65049,64713,336,76390000,75800000,590000
2019-05-01,Ang Thong ,central,0.732,20667,69923,69159,764,91970000,91110000,860000
2019-05-01,Nonthaburi ,central,0.6976,83987,240456,212079,28377,418080000,358550000,59530000
2019-05-01,Pathum Thani ,central,0.5243,45058,161920,115443,46477,310050000,163650000,146400000
2019-05-01,Samut Prakan ,central,0.5728,93920,286530,217158,69372,524590000,337270000,187320000
2019-05-01,Samut Sakhon ,central,0.6234000000000001,63594,91543,91345,198,166030000,165580000,450000
2019-05-01,Chachoengsao ,east,0.612,45558,324862,323575,1287,514280000,511310000,2970000
2019-05-01,Ratchaburi ,central,0.4932,67137,204739,200061,4678,349080000,340390000,8690000
2019-05-01,Kanchanaburi ,central,0.5976,251166,788522,750448,38074,2092030000,1937800000,154230000
2019-05-01,Samut Songkhram ,central,0.6455,51663,143986,140372,3614,206990000,201320000,5670000
2019-05-01,Suphan Buri ,central,0.7502,77143,170020,167537,2483,360630000,353790000,6840000
2019-05-01,Phetchaburi ,central,0.7075,307891,711498,681344,30154,2336200000,1986300000,349900000
2019-05-01,Prachuap Khiri Khan ,central,0.4654,335222,514547,446022,68525,2803370000,1965950000,837420000
2019-05-01,Chonburi ,east,0.8216,1408665,1690412,817301,873111,25648650000,5098310000,20550340000
2019-05-01,Chanthaburi ,east,0.6153,153920,238905,229036,9869,940480000,872110000,68370000
2019-05-01,Trat ,east,0.7051999999999999,181493,206074,170707,35367,1735520000,1197600000,537920000
2019-05-01,Nakhon Nayok ,east,0.6168,149872,253601,252674,927,680030000,677210000,2820000
2019-05-01,Prachinburi ,east,0.5036999999999999,99016,161113,153539,7574,502150000,457650000,44500000
2019-05-01,Rayong ,east,0.8037000000000001,443647,735125,699836,35289,3002130000,2689060000,313070000
2019-05-01,Sa Kaeo ,east,0.595,64045,182432,164882,17550,558920000,511070000,47850000
2019-05-01,Phuket ,south,0.6825,839220,930340,92991,837349,28004850000,1055080000,26949770000
2019-05-01,Phatthalung ,south,0.6839,77579,127454,123113,4341,306670000,296950000,9720000
2019-05-01,Trang ,south,0.6218,91843,140857,129242,11615,785380000,690900000,94480000
2019-05-01,Ranong ,south,0.5629,56011,67981,64514,3467,425090000,398290000,26800000
2019-05-01,Chumphon ,south,0.7009000000000001,113917,131108,123214,7894,684470000,653250000,31220000
2019-05-01,Pattani ,south,0.5984,25054,26215,26118,97,94560000,94170000,390000
2019-05-01,Yala ,south,0.5524,55322,59471,8245,51226,308040000,26290000,281750000
2019-05-01,Nakhon Si Thammarat ,south,0.6514,250839,389122,386056,3066,2017150000,2000710000,16440000
2019-05-01,Narathiwat ,south,0.6235,59793,63667,22440,41227,334500000,105220000,229280000
2019-05-01,Krabi ,south,0.6534,331406,615062,236314,378748,7839310000,3294910000,4544400000
2019-05-01,Songkhla ,south,0.6988,425660,558588,334338,224250,5206620000,2507270000,2699350000
2019-05-01,Phang Nga ,south,0.5966,79288,407912,131544,276368,3637300000,575730000,3061570000
2019-05-01,Surat Thani ,south,0.6707,394486,432897,174696,258201,6912830000,1404970000,5507860000
2019-05-01,Satun ,south,0.6851,70882,113147,98821,14326,487930000,427170000,60760000
2019-05-01,Kamphaeng Phet ,north,0.4316,31795,59938,57264,2674,136730000,132350000,4380000
2019-05-01,Chiang Rai ,north,0.4623,225609,272121,231496,40625,1992200000,1487420000,504780000
2019-05-01,Chiang Mai ,north,0.6837000000000001,663597,759952,512041,247911,7282570000,4370460000,2912110000
2019-05-01,Phichit ,north,0.4916,29401,72458,71827,631,103330000,102080000,1250000
2019-05-01,Nakhon Sawan ,north,0.49340000000000006,76571,208263,204491,3772,433010000,425600000,7410000
2019-05-01,Tak ,north,0.6228,142153,197542,196151,1391,639220000,634790000,4430000
2019-05-01,Phitsanulok ,north,0.5309,142716,259251,248645,10606,570780000,517490000,53290000
2019-05-01,Phayao ,north,0.4089,17607,32696,31831,865,64770000,63460000,1310000
2019-05-01,Phetchabun ,north,0.4485,145400,180094,177811,2283,551480000,542230000,9250000
2019-05-01,Phrae ,north,0.5144,24092,60553,56518,4035,115480000,103440000,12040000
2019-05-01,Lampang ,north,0.5986,48317,87168,83304,3864,280580000,261170000,19410000
2019-05-01,Lamphun ,north,0.5573,21025,88007,84938,3069,121860000,118290000,3570000
2019-05-01,Mae Hong Son ,north,0.3145,58747,65764,47788,17976,373620000,201980000,171640000
2019-05-01,Uttaradit ,north,0.5347,52687,68714,68318,396,167880000,167200000,680000
2019-05-01,Uthai Thani ,north,0.426,25958,58257,57537,720,94440000,92910000,1530000
2019-05-01,Sukhothai ,north,0.5569,72204,127947,103951,23996,285370000,212660000,72710000
2019-05-01,Nan ,north,0.6019,56523,81819,80269,1550,271460000,265790000,5670000
2019-05-01,Kalasin ,east_northeast,0.5576,23646,57244,56864,380,112420000,111660000,760000
2019-05-01,Khon Kaen ,east_northeast,0.5184000000000001,183914,407099,401186,5913,1233540000,1198660000,34880000
2019-05-01,Chaiyaphum ,east_northeast,0.5325,73253,142506,141216,1290,179930000,177830000,2100000
2019-05-01,Nakhon Phanom ,east_northeast,0.5644,35555,91932,82725,9207,180080000,167630000,12450000
2019-05-01,Nakhon Ratchasima ,east_northeast,0.5756,448391,819281,804088,15193,1934430000,1870700000,63730000
2019-05-01,Buriram ,east_northeast,0.5438000000000001,93781,193843,189710,4133,274200000,268160000,6040000
2019-05-01,Maha Sarakham ,east_northeast,0.48369999999999996,36200,59862,59108,754,125500000,123840000,1660000
2019-05-01,Mukdahan ,east_northeast,0.5299,53983,177818,160011,17807,260330000,227470000,32860000
2019-05-01,Roi Et ,east_northeast,0.4669,34001,69734,69018,716,112640000,111030000,1610000
2019-05-01,Loei ,east_northeast,0.5039,92249,168175,165899,2276,317060000,309750000,7310000
2019-05-01,Sisaket ,south,0.5268,26597,138356,136898,1458,182840000,178340000,4500000
2019-05-01,Surin ,east_northeast,0.5352,75190,107108,104984,2124,212740000,203400000,9340000
2019-05-01,Nong Khai ,east_northeast,0.6151,95987,270927,221693,49234,543500000,476360000,67140000
2019-05-01,Bueng Kan ,east_northeast,0.5517,21618,49634,48908,726,73240000,71920000,1320000
2019-05-01,Udon Thani ,east_northeast,0.728,188311,342307,331266,11041,934450000,883670000,50780000
2019-05-01,Ubon Ratchathani ,east_northeast,0.6574,111533,282088,269135,12953,645720000,594350000,51370000
2019-05-01,Sakon Nakhon ,east_northeast,0.5721,73166,140252,139651,601,268040000,265520000,2520000
2019-05-01,Yasothon ,east_northeast,0.6653,17536,62611,60873,1738,113250000,108070000,5180000
2019-05-01,Amnat Charoen ,east_northeast,0.5624,7296,22436,21816,620,30110000,27780000,2330000
2019-05-01,Nong Bua Lamphu ,east_northeast,0.45549999999999996,10113,22905,22791,114,25490000,25340000,150000
2019-06-01,Bangkok,central,0.7414000000000001,2730212,4821534,2890456,1931078,74862520000,27583910000,47278610000
2019-06-01,Lopburi ,central,0.5434,44546,186741,185406,1335,351320000,347460000,3860000
2019-06-01,Phra Nakhon Si Ayutthaya ,central,0.5939,82229,635178,463432,171746,1775710000,1128500000,647210000
2019-06-01,Saraburi ,central,0.5596,68969,334343,330589,3754,490180000,483610000,6570000
2019-06-01,Chainat ,central,0.7303000000000001,23450,77614,77342,272,122720000,122170000,550000
2019-06-01,Nakhon Pathom ,central,0.7221,109610,274396,266285,8111,392780000,378980000,13800000
2019-06-01,Sing Buri ,central,0.6142,15121,64014,63679,335,75170000,74580000,590000
2019-06-01,Ang Thong ,central,0.6927,18583,63117,62095,1022,82960000,81810000,1150000
2019-06-01,Nonthaburi ,central,0.6463,81506,234108,209622,24486,405780000,354410000,51370000
2019-06-01,Pathum Thani ,central,0.5047,43242,152546,115832,36714,279860000,164210000,115650000
2019-06-01,Samut Prakan ,central,0.5739,91008,277505,209494,68011,509010000,325370000,183640000
2019-06-01,Samut Sakhon ,central,0.5861,58934,84837,84647,190,153860000,153440000,420000
2019-06-01,Chachoengsao ,east,0.5557,40885,291289,289940,1349,461320000,458190000,3130000
2019-06-01,Ratchaburi ,central,0.4677,52990,162225,157131,5094,276810000,267360000,9450000
2019-06-01,Kanchanaburi ,central,0.5822999999999999,229213,717779,677702,40077,1912300000,1749960000,162340000
2019-06-01,Samut Songkhram ,central,0.5377000000000001,47567,132730,129129,3601,190840000,185210000,5630000
2019-06-01,Suphan Buri ,central,0.7426,80569,177583,174705,2878,376850000,368920000,7930000
2019-06-01,Phetchaburi ,central,0.6249,264852,613695,589475,24220,1999530000,1718480000,281050000
2019-06-01,Prachuap Khiri Khan ,central,0.4129,309372,470316,397690,72626,2640440000,1752920000,887520000
2019-06-01,Chonburi ,east,0.7551000000000001,1272728,1541183,784721,756462,22752190000,4895040000,17857150000
2019-06-01,Chanthaburi ,east,0.6208,153288,238059,226915,11144,941220000,864030000,77190000
2019-06-01,Trat ,east,0.5922999999999999,145191,164839,136159,28680,1391310000,955240000,436070000
2019-06-01,Nakhon Nayok ,east,0.6195,137656,232941,232071,870,624630000,621990000,2640000
2019-06-01,Prachinburi ,east,0.5178,83396,135349,128275,7074,423910000,382340000,41570000
2019-06-01,Rayong ,east,0.8049,437564,724951,691326,33625,2954660000,2656360000,298300000
2019-06-01,Sa Kaeo ,east,0.564,64022,182463,164664,17799,558920000,510390000,48530000
2019-06-01,Phuket ,south,0.7497,1061379,1181192,296803,884389,31831300000,3367540000,28463760000
2019-06-01,Phatthalung ,south,0.6389,64655,105663,102934,2729,254410000,248300000,6110000
2019-06-01,Trang ,south,0.44170000000000004,61901,94752,86071,8681,530740000,460130000,70610000
2019-06-01,Ranong ,south,0.5492,52726,64003,59443,4560,402250000,367000000,35250000
2019-06-01,Chumphon ,south,0.6668000000000001,110778,127451,120207,7244,665960000,637300000,28660000
2019-06-01,Pattani ,south,0.8131999999999999,21660,22668,22552,116,81800000,81320000,480000
2019-06-01,Yala ,south,0.518,50676,54492,4224,50268,289920000,13460000,276460000
2019-06-01,Nakhon Si Thammarat ,south,0.5425,209065,324718,320509,4209,1683590000,1661030000,22560000
2019-06-01,Narathiwat ,south,0.5166,48227,51177,11015,40162,275040000,51660000,223380000
2019-06-01,Krabi ,south,0.5328,275731,541085,164162,376923,6811420000,2288910000,4522510000
2019-06-01,Songkhla ,south,0.6487999999999999,368099,467937,234785,233152,4567220000,1760720000,2806500000
2019-06-01,Phang Nga ,south,0.5567,67162,358485,81748,276737,3423430000,357790000,3065640000
2019-06-01,Surat Thani ,south,0.5871,347860,383680,164863,218817,5993670000,1325910000,4667760000
2019-06-01,Satun ,south,0.5927,60615,97514,82088,15426,420270000,354840000,65430000
2019-06-01,Kamphaeng Phet ,north,0.4435,32150,60458,58012,2446,138080000,134080000,4000000
2019-06-01,Chiang Rai ,north,0.4039,197284,237699,199713,37986,1755190000,1283200000,471990000
2019-06-01,Chiang Mai ,north,0.6915,659246,753272,498717,254555,7246880000,4256740000,2990140000
2019-06-01,Phichit ,north,0.43689999999999996,25369,62521,61969,552,89170000,88070000,1100000
2019-06-01,Nakhon Sawan ,north,0.5158,79635,216622,212617,4005,450360000,442520000,7840000
2019-06-01,Tak ,north,0.5937,131440,182675,181264,1411,591090000,586610000,4480000
2019-06-01,Phitsanulok ,north,0.528,146262,266099,255884,10215,583880000,532550000,51330000
2019-06-01,Phayao ,north,0.3993,17017,31987,30712,1275,63170000,61240000,1930000
2019-06-01,Phetchabun ,north,0.4347,141950,175836,173532,2304,538530000,529190000,9340000
2019-06-01,Phrae ,north,0.4321,19883,49829,46272,3557,95300000,84690000,10610000
2019-06-01,Lampang ,north,0.5761999999999999,45953,82772,78644,4128,267310000,246570000,20740000
2019-06-01,Lamphun ,north,0.5231,19567,82308,78191,4117,113680000,108880000,4800000
2019-06-01,Mae Hong Son ,north,0.30820000000000003,54882,61113,41266,19847,364100000,174400000,189700000
2019-06-01,Uttaradit ,north,0.5094,49696,64821,64404,417,158340000,157620000,720000
2019-06-01,Uthai Thani ,north,0.4147,24536,55056,54319,737,89260000,87720000,1540000
2019-06-01,Sukhothai ,north,0.5572,68256,120947,98335,22612,269700000,201170000,68530000
2019-06-01,Nan ,north,0.5623,51017,73738,71986,1752,244760000,238350000,6410000
2019-06-01,Kalasin ,east_northeast,0.5577000000000001,22756,55086,54761,325,108190000,107540000,650000
2019-06-01,Khon Kaen ,east_northeast,0.5533,185698,411152,404740,6412,1247070000,1209250000,37820000
2019-06-01,Chaiyaphum ,east_northeast,0.5892000000000001,75654,147178,145781,1397,185860000,183590000,2270000
2019-06-01,Nakhon Phanom ,east_northeast,0.5681,34858,89809,81318,8491,176250000,164770000,11480000
2019-06-01,Nakhon Ratchasima ,east_northeast,0.5546,427592,781814,769072,12742,1842990000,1789210000,53780000
2019-06-01,Buriram ,east_northeast,0.5602,93944,193969,190240,3729,274360000,268910000,5450000
2019-06-01,Maha Sarakham ,east_northeast,0.47479999999999994,34327,56756,56133,623,118970000,117620000,1350000
2019-06-01,Mukdahan ,east_northeast,0.5257000000000001,47028,154745,139486,15259,226430000,198280000,28150000
2019-06-01,Roi Et ,east_northeast,0.4779,34336,70416,69792,624,113690000,112270000,1420000
2019-06-01,Loei ,east_northeast,0.5886,101848,185677,183165,2512,350030000,341980000,8050000
2019-06-01,Sisaket ,south,0.5478999999999999,26567,138204,136750,1454,182640000,178150000,4490000
2019-06-01,Surin ,east_northeast,0.5001,69586,99078,97476,1602,195890000,188850000,7040000
2019-06-01,Nong Khai ,east_northeast,0.5483,81468,237819,187131,50688,471220000,402100000,69120000
2019-06-01,Bueng Kan ,east_northeast,0.5693,21594,49578,48860,718,73160000,71840000,1320000
2019-06-01,Udon Thani ,east_northeast,0.6947,172223,313347,301798,11549,858180000,805060000,53120000
2019-06-01,Ubon Ratchathani ,east_northeast,0.6258,101417,256352,243772,12580,588200000,538330000,49870000
2019-06-01,Sakon Nakhon ,east_northeast,0.5590999999999999,66671,127830,127327,503,244190000,242080000,2110000
2019-06-01,Yasothon ,east_northeast,0.5941,15844,56638,55116,1522,102370000,97840000,4530000
2019-06-01,Amnat Charoen ,east_northeast,0.4885,6454,19714,19094,620,26630000,24300000,2330000
2019-06-01,Nong Bua Lamphu ,east_northeast,0.48100000000000004,11457,25922,25856,66,28830000,28750000,80000
2019-07-01,Bangkok,central,0.7854000000000001,3008999,6131044,3895533,2235511,104035660000,44719800000,59315860000
2019-07-01,Lopburi ,central,0.47859999999999997,38352,382896,381273,1623,534740000,531920000,2820000
2019-07-01,Phra Nakhon Si Ayutthaya ,central,0.5719,78614,742818,553104,189714,1394250000,949950000,444300000
2019-07-01,Saraburi ,central,0.4918,55597,421328,410699,10629,511680000,498340000,13340000
2019-07-01,Chainat ,central,0.7139,24004,66583,66109,474,108190000,107380000,810000
2019-07-01,Nakhon Pathom ,central,0.7543000000000001,116937,494985,479509,15476,684400000,653730000,30670000
2019-07-01,Sing Buri ,central,0.5678,15311,38466,38093,373,63020000,62460000,560000
2019-07-01,Ang Thong ,central,0.6129,15891,66034,60045,5989,72330000,65470000,6860000
2019-07-01,Nonthaburi ,central,0.5781000000000001,80728,203964,188347,15617,306180000,272990000,33190000
2019-07-01,Pathum Thani ,central,0.4639,36148,160010,105295,54715,238100000,133770000,104330000
2019-07-01,Samut Prakan ,central,0.5722,89536,264808,179892,84916,525110000,272020000,253090000
2019-07-01,Samut Sakhon ,central,0.6108,50745,118299,117937,362,149390000,148880000,510000
2019-07-01,Chachoengsao ,east,0.5748,43081,292809,290878,1931,448540000,443170000,5370000
2019-07-01,Ratchaburi ,central,0.5642,83406,224243,219540,4703,424130000,411540000,12590000
2019-07-01,Kanchanaburi ,central,0.6735,241155,851628,816587,35041,2206550000,2060660000,145890000
2019-07-01,Samut Songkhram ,central,0.6218,57945,142088,137880,4208,214140000,207870000,6270000
2019-07-01,Suphan Buri ,central,0.7418,64004,212187,210391,1796,349830000,345640000,4190000
2019-07-01,Phetchaburi ,central,0.6748000000000001,326995,716742,683936,32806,2320010000,2011280000,308730000
2019-07-01,Prachuap Khiri Khan ,central,0.4241,321644,559896,461809,98087,3179300000,1819610000,1359690000
2019-07-01,Chonburi ,east,0.7436,1106315,1305356,577241,728115,13228710000,3228750000,9999960000
2019-07-01,Chanthaburi ,east,0.6021,131601,166171,158020,8151,583770000,549330000,34440000
2019-07-01,Trat ,east,0.5485,151318,162788,137697,25091,1240350000,881860000,358490000
2019-07-01,Nakhon Nayok ,east,0.6901999999999999,176130,293370,290508,2862,601520000,591700000,9820000
2019-07-01,Prachinburi ,east,0.556,79951,120794,115064,5730,377700000,357450000,20250000
2019-07-01,Rayong ,east,0.6923,308020,586240,540938,45302,2785330000,2333690000,451640000
2019-07-01,Sa Kaeo ,east,0.544,67138,167791,144500,23291,510540000,459580000,50960000
2019-07-01,Phuket ,south,0.6617000000000001,748133,811130,225708,585422,20503170000,2974040000,17529130000
2019-07-01,Phatthalung ,south,0.6453,70790,106525,105390,1135,326650000,322910000,3740000
2019-07-01,Trang ,south,0.3911,55758,64939,53230,11709,409610000,322660000,86950000
2019-07-01,Ranong ,south,0.5018,57228,70961,67454,3507,359490000,333490000,26000000
2019-07-01,Chumphon ,south,0.6275999999999999,124181,174302,161480,12822,859750000,750340000,109410000
2019-07-01,Pattani ,south,0.535,22673,24237,24018,219,107620000,106710000,910000
2019-07-01,Yala ,south,0.5291,57024,58323,14380,43943,289460000,56940000,232520000
2019-07-01,Nakhon Si Thammarat ,south,0.5357999999999999,168746,253286,246443,6843,988160000,959030000,29130000
2019-07-01,Narathiwat ,south,0.5223,50799,54136,17932,36204,291140000,80500000,210640000
2019-07-01,Krabi ,south,0.525,277123,355556,155302,200254,5659620000,2387260000,3272360000
2019-07-01,Songkhla ,south,0.6965,413807,644488,391253,253235,5492200000,2866650000,2625550000
2019-07-01,Phang Nga ,south,0.4661,72531,243919,51858,192061,2761830000,186570000,2575260000
2019-07-01,Surat Thani ,south,0.7371,464073,530400,200672,329728,7403090000,1426940000,5976150000
2019-07-01,Satun ,south,0.5134000000000001,58483,97396,87896,9500,330490000,293940000,36550000
2019-07-01,Kamphaeng Phet ,north,0.4154,27655,47173,45676,1497,83720000,81540000,2180000
2019-07-01,Chiang Rai ,north,0.41840000000000005,191628,218173,158957,59216,1798000000,1170340000,627660000
2019-07-01,Chiang Mai ,north,0.6903,655029,714171,432346,281825,7839640000,3962240000,3877400000
2019-07-01,Phichit ,north,0.4658,32616,79787,79409,378,110950000,110560000,390000
2019-07-01,Nakhon Sawan ,north,0.47200000000000003,67478,99697,98202,1495,189910000,187400000,2510000
2019-07-01,Tak ,north,0.5672,116558,145409,141251,4158,477520000,467310000,10210000
2019-07-01,Phitsanulok ,north,0.5429999999999999,141704,221480,207837,13643,516710000,472170000,44540000
2019-07-01,Phayao ,north,0.41850000000000004,18836,52281,50637,1644,119800000,117670000,2130000
2019-07-01,Phetchabun ,north,0.4506,122142,145884,143080,2804,402450000,391160000,11290000
2019-07-01,Phrae ,north,0.4447,28578,64883,61945,2938,123340000,116510000,6830000
2019-07-01,Lampang ,north,0.5249,37848,95714,87835,7879,297740000,274080000,23660000
2019-07-01,Lamphun ,north,0.4806,17963,86537,83986,2551,94850000,92510000,2340000
2019-07-01,Mae Hong Son ,north,0.3075,43270,44417,29128,15289,225340000,111270000,114070000
2019-07-01,Uttaradit ,north,0.5446,44572,93546,92478,1068,198830000,197390000,1440000
2019-07-01,Uthai Thani ,north,0.43810000000000004,26456,48690,48220,470,87680000,86170000,1510000
2019-07-01,Sukhothai ,north,0.5648,65591,97696,61010,36686,229120000,125350000,103770000
2019-07-01,Nan ,north,0.5289,46737,59815,58624,1191,148640000,144630000,4010000
2019-07-01,Kalasin ,east_northeast,0.5112,20466,88840,88458,382,126180000,125450000,730000
2019-07-01,Khon Kaen ,east_northeast,0.6193,219224,380020,370041,9979,1421720000,1386700000,35020000
2019-07-01,Chaiyaphum ,east_northeast,0.6402,94995,236369,235676,693,223360000,221650000,1710000
2019-07-01,Nakhon Phanom ,east_northeast,0.5556,34765,89317,82796,6521,165180000,155850000,9330000
2019-07-01,Nakhon Ratchasima ,east_northeast,0.6045,430254,765523,750725,14798,2081510000,2018600000,62910000
2019-07-01,Buriram ,east_northeast,0.5385,89281,143460,139178,4282,261010000,254310000,6700000
2019-07-01,Maha Sarakham ,east_northeast,0.45189999999999997,37552,61012,60532,480,72050000,71440000,610000
2019-07-01,Mukdahan ,east_northeast,0.5579999999999999,43614,170224,155953,14271,315720000,284930000,30790000
2019-07-01,Roi Et ,east_northeast,0.5307,42014,76842,76455,387,129900000,129270000,630000
2019-07-01,Loei ,east_northeast,0.4986,77242,154986,151199,3787,309500000,299370000,10130000
2019-07-01,Sisaket ,south,0.5665,30925,112030,110192,1838,132470000,127530000,4940000
2019-07-01,Surin ,east_northeast,0.5475,87827,114675,113022,1653,205150000,200810000,4340000
2019-07-01,Nong Khai ,east_northeast,0.5689,90751,187024,138614,48410,412460000,345560000,66900000
2019-07-01,Bueng Kan ,east_northeast,0.5254,22905,38393,37893,500,70380000,69180000,1200000
2019-07-01,Udon Thani ,east_northeast,0.6855,183671,341236,323899,17337,1054150000,1001230000,52920000
2019-07-01,Ubon Ratchathani ,east_northeast,0.6847,123278,210463,197713,12750,522410000,478210000,44200000
2019-07-01,Sakon Nakhon ,east_northeast,0.5244,50626,100223,99710,513,174740000,173880000,860000
2019-07-01,Yasothon ,east_northeast,0.5333,16607,52062,50822,1240,51110000,48590000,2520000
2019-07-01,Amnat Charoen ,east_northeast,0.513,7652,20517,19749,768,21680000,19440000,2240000
2019-07-01,Nong Bua Lamphu ,east_northeast,0.4204,10380,22524,22429,95,24300000,24150000,150000
2019-08-01,Bangkok,central,0.7909999999999999,3075987,5941743,3534912,2406831,104441520000,40579960000,63861560000
2019-08-01,Lopburi ,central,0.4374,36460,363465,361702,1763,507680000,504620000,3060000
2019-08-01,Phra Nakhon Si Ayutthaya ,central,0.5575,76653,732055,515601,216454,1392460000,885540000,506920000
2019-08-01,Saraburi ,central,0.4692,54505,412838,403119,9719,501340000,489140000,12200000
2019-08-01,Chainat ,central,0.6223,21189,58782,58385,397,95510000,94830000,680000
2019-08-01,Nakhon Pathom ,central,0.7098,110696,468164,455486,12678,646100000,620970000,25130000
2019-08-01,Sing Buri ,central,0.5043,13880,34859,34573,286,57120000,56690000,430000
2019-08-01,Ang Thong ,central,0.5478000000000001,13654,54604,51666,2938,59690000,56330000,3360000
2019-08-01,Nonthaburi ,central,0.5805,79861,201940,188051,13889,302070000,272560000,29510000
2019-08-01,Pathum Thani ,central,0.4715,37269,168747,104669,64078,255150000,132970000,122180000
2019-08-01,Samut Prakan ,central,0.5779,86196,254056,170196,83860,507310000,257360000,249950000
2019-08-01,Samut Sakhon ,central,0.5239,47247,110147,109758,389,139100000,138550000,550000
2019-08-01,Chachoengsao ,east,0.5321,38773,263583,261872,1711,403740000,398980000,4760000
2019-08-01,Ratchaburi ,central,0.5084000000000001,74095,199361,194320,5041,377770000,364270000,13500000
2019-08-01,Kanchanaburi ,central,0.6302,226684,800605,768006,32599,2073780000,1938060000,135720000
2019-08-01,Samut Songkhram ,central,0.5524,51984,128192,123453,4739,193180000,186120000,7060000
2019-08-01,Suphan Buri ,central,0.6926000000000001,60327,199908,197809,2099,329870000,324970000,4900000
2019-08-01,Phetchaburi ,central,0.6496999999999999,307547,674547,644334,30213,2179150000,1894820000,284330000
2019-08-01,Prachuap Khiri Khan ,central,0.3968,325568,572472,482492,89980,3148410000,1901100000,1247310000
2019-08-01,Chonburi ,east,0.759,1152253,1369703,640705,728998,13595810000,3583720000,10012090000
2019-08-01,Chanthaburi ,east,0.5075,115377,145697,138506,7191,511880000,481490000,30390000
2019-08-01,Trat ,east,0.4982,138192,148666,125771,22895,1132600000,805480000,327120000
2019-08-01,Nakhon Nayok ,east,0.613,156790,261140,258775,2365,535190000,527070000,8120000
2019-08-01,Prachinburi ,east,0.5909,82244,124224,118655,5569,388290000,368610000,19680000
2019-08-01,Rayong ,east,0.5865,264248,502973,464192,38781,2389220000,2002590000,386630000
2019-08-01,Sa Kaeo ,east,0.4924,61546,152869,132671,20198,466150000,421960000,44190000
2019-08-01,Phuket ,south,0.6211,720398,794213,297163,497050,18798600000,3915570000,14883030000
2019-08-01,Phatthalung ,south,0.6231,64799,97428,96133,1295,298820000,294550000,4270000
2019-08-01,Trang ,south,0.39149999999999996,54258,63067,55525,7542,392580000,336570000,56010000
2019-08-01,Ranong ,south,0.446,55280,68441,63856,4585,349690000,315700000,33990000
2019-08-01,Chumphon ,south,0.5228,105030,147042,131714,15328,742830000,612030000,130800000
2019-08-01,Pattani ,south,0.8601000000000001,18317,19587,19359,228,86960000,86010000,950000
2019-08-01,Yala ,south,0.5619,62974,64467,21153,43314,312950000,83760000,229190000
2019-08-01,Nakhon Si Thammarat ,south,0.5303,205132,306587,300855,5732,1195170000,1170770000,24400000
2019-08-01,Narathiwat ,south,0.7855,47814,50966,17497,33469,273280000,78550000,194730000
2019-08-01,Krabi ,south,0.5106,251172,324731,123865,200866,5186380000,1904020000,3282360000
2019-08-01,Songkhla ,south,0.6648999999999999,418228,624598,338345,286253,5446880000,2479000000,2967880000
2019-08-01,Phang Nga ,south,0.3906,65484,219355,58695,160660,2365380000,211170000,2154210000
2019-08-01,Surat Thani ,south,0.6934999999999999,491537,569418,258032,311386,7478520000,1834810000,5643710000
2019-08-01,Satun ,south,0.4036,43634,72437,62891,9546,247040000,210320000,36720000
2019-08-01,Kamphaeng Phet ,north,0.3539,24482,41675,40488,1187,74010000,72280000,1730000
2019-08-01,Chiang Rai ,north,0.4106,182721,206484,157533,48951,1678710000,1159860000,518850000
2019-08-01,Chiang Mai ,north,0.6575,599142,653758,401536,252222,7150000000,3679880000,3470120000
2019-08-01,Phichit ,north,0.45409999999999995,32250,78884,78521,363,109710000,109330000,380000
2019-08-01,Nakhon Sawan ,north,0.4338,61465,90925,89339,1586,173150000,170490000,2660000
2019-08-01,Tak ,north,0.5356000000000001,106797,133730,129181,4549,438550000,427370000,11180000
2019-08-01,Phitsanulok ,north,0.5386,141378,221759,210540,11219,514930000,478310000,36620000
2019-08-01,Phayao ,north,0.40090000000000003,18136,50178,48784,1394,115170000,113370000,1800000
2019-08-01,Phetchabun ,north,0.3947,108346,129279,127442,1837,355800000,348410000,7390000
2019-08-01,Phrae ,north,0.41229999999999994,26635,60459,57742,2717,114930000,108610000,6320000
2019-08-01,Lampang ,north,0.4535,33530,84761,77969,6792,263680000,243290000,20390000
2019-08-01,Lamphun ,north,0.4252,15962,76912,74554,2358,84280000,82120000,2160000
2019-08-01,Mae Hong Son ,north,0.2954,42177,43299,27621,15678,222490000,105510000,116980000
2019-08-01,Uttaradit ,north,0.44789999999999996,37663,78991,78164,827,167950000,166840000,1110000
2019-08-01,Uthai Thani ,north,0.40630000000000005,25112,46170,45623,547,83290000,81530000,1760000
2019-08-01,Sukhothai ,north,0.5078,57258,85716,52621,33095,201730000,108120000,93610000
2019-08-01,Nan ,north,0.48369999999999996,41780,53440,52133,1307,133010000,128610000,4400000
2019-08-01,Kalasin ,east_northeast,0.46649999999999997,17606,76427,76088,339,108560000,107910000,650000
2019-08-01,Khon Kaen ,east_northeast,0.5228,191838,332572,324339,8233,1244320000,1215430000,28890000
2019-08-01,Chaiyaphum ,east_northeast,0.6073,83298,207066,206169,897,196110000,193900000,2210000
2019-08-01,Nakhon Phanom ,east_northeast,0.5794,37905,96980,90300,6680,179540000,169980000,9560000
2019-08-01,Nakhon Ratchasima ,east_northeast,0.5932999999999999,410928,731297,719528,11769,1984740000,1934710000,50030000
2019-08-01,Buriram ,east_northeast,0.48469999999999996,78339,125950,122022,3928,229100000,222960000,6140000
2019-08-01,Maha Sarakham ,east_northeast,0.42479999999999996,36060,58573,57954,619,69180000,68400000,780000
2019-08-01,Mukdahan ,east_northeast,0.5143,39807,155460,142316,13144,288370000,260010000,28360000
2019-08-01,Roi Et ,east_northeast,0.42869999999999997,38164,69789,69473,316,117970000,117460000,510000
2019-08-01,Loei ,east_northeast,0.4689,80237,161071,156444,4627,322130000,309750000,12380000
2019-08-01,Sisaket ,south,0.5181,27865,100595,98688,1907,119350000,114220000,5130000
2019-08-01,Surin ,east_northeast,0.49329999999999996,81292,106213,104412,1801,190240000,185510000,4730000
2019-08-01,Nong Khai ,east_northeast,0.5194,82225,182424,124419,58005,390340000,310180000,80160000
2019-08-01,Bueng Kan ,east_northeast,0.5024000000000001,21483,36025,35508,517,66070000,64830000,1240000
2019-08-01,Udon Thani ,east_northeast,0.6748999999999999,180955,336702,318342,18360,1040100000,984050000,56050000
2019-08-01,Ubon Ratchathani ,east_northeast,0.588,102191,174522,164506,10016,432610000,397890000,34720000
2019-08-01,Sakon Nakhon ,east_northeast,0.5523,51898,102747,102208,539,179130000,178230000,900000
2019-08-01,Yasothon ,east_northeast,0.42200000000000004,13881,43635,42681,954,42750000,40810000,1940000
2019-08-01,Amnat Charoen ,east_northeast,0.41009999999999996,6243,16708,16056,652,17700000,15800000,1900000
2019-08-01,Nong Bua Lamphu ,east_northeast,0.4445,12124,26308,26208,100,28380000,28220000,160000
2019-09-01,Bangkok,central,0.7831999999999999,2838616,5966121,3925188,2040933,99213280000,45060240000,54153040000
2019-09-01,Lopburi ,central,0.42969999999999997,34959,348358,346610,1748,486610000,483570000,3040000
2019-09-01,Phra Nakhon Si Ayutthaya ,central,0.5017,69618,656622,493449,163173,1229620000,847500000,382120000
2019-09-01,Saraburi ,central,0.4738,51166,387872,377687,10185,471080000,458290000,12790000
2019-09-01,Chainat ,central,0.6978,23130,64189,63803,386,104310000,103640000,670000
2019-09-01,Nakhon Pathom ,central,0.6570999999999999,99862,422268,411194,11074,582550000,560610000,21940000
2019-09-01,Sing Buri ,central,0.5402,14284,35872,35598,274,58770000,58370000,400000
2019-09-01,Ang Thong ,central,0.5867,15076,60432,57042,3390,66080000,62200000,3880000
2019-09-01,Nonthaburi ,central,0.5334,73064,184529,169738,14791,277460000,246030000,31430000
2019-09-01,Pathum Thani ,central,0.44270000000000004,32958,144724,97203,47521,214100000,123490000,90610000
2019-09-01,Samut Prakan ,central,0.5564,85854,252151,166462,85689,507100000,251710000,255390000
2019-09-01,Samut Sakhon ,central,0.5574,44943,104774,104437,337,132330000,131840000,490000
2019-09-01,Chachoengsao ,east,0.5385,39815,270653,268890,1763,414570000,409650000,4920000
2019-09-01,Ratchaburi ,central,0.4972,69885,188109,182916,5193,356800000,342900000,13900000
2019-09-01,Kanchanaburi ,central,0.5978,217147,766054,731152,34902,1990350000,1845050000,145300000
2019-09-01,Samut Songkhram ,central,0.5331,49155,120983,116813,4170,182320000,176110000,6210000
2019-09-01,Suphan Buri ,central,0.7389,62835,208223,206057,2166,343590000,338520000,5070000
2019-09-01,Phetchaburi ,central,0.6084,287466,628587,597495,31092,2049690000,1757090000,292600000
2019-09-01,Prachuap Khiri Khan ,central,0.3544,277715,485736,404783,80953,2717060000,1594900000,1122160000
2019-09-01,Chonburi ,east,0.7232,1050750,1252436,597467,654969,12378570000,3341870000,9036700000
2019-09-01,Chanthaburi ,east,0.544,117448,148287,141054,7233,520930000,490370000,30560000
2019-09-01,Trat ,east,0.5229,142205,152983,129727,23256,1165930000,834740000,331190000
2019-09-01,Nakhon Nayok ,east,0.6446999999999999,161697,269332,266679,2653,552290000,543180000,9110000
2019-09-01,Prachinburi ,east,0.5958,78292,118213,113290,4923,369360000,351950000,17410000
2019-09-01,Rayong ,east,0.6054999999999999,267300,507120,464670,42450,2427870000,2004660000,423210000
2019-09-01,Sa Kaeo ,east,0.5182,64395,159756,138855,20901,487370000,441640000,45730000
2019-09-01,Phuket ,south,0.6145,765910,834314,254797,579517,20709630000,3357330000,17352300000
2019-09-01,Phatthalung ,south,0.6145,62581,94188,93236,952,288820000,285670000,3150000
2019-09-01,Trang ,south,0.47119999999999995,64134,74575,64787,9788,465400000,392700000,72700000
2019-09-01,Ranong ,south,0.5063,62471,77355,72288,5067,394950000,357380000,37570000
2019-09-01,Chumphon ,south,0.5408,92956,130274,118316,11958,651820000,549770000,102050000
2019-09-01,Pattani ,south,0.9286,19752,21119,20903,216,93740000,92860000,880000
2019-09-01,Yala ,south,0.5328,55453,56726,14724,42002,280550000,58300000,222250000
2019-09-01,Nakhon Si Thammarat ,south,0.5722999999999999,200381,299485,293890,5595,1167500000,1143670000,23830000
2019-09-01,Narathiwat ,south,0.8582,51463,54861,19116,35745,293780000,85820000,207960000
2019-09-01,Krabi ,south,0.5716,267973,348461,118428,230033,5579430000,1820430000,3759000000
2019-09-01,Songkhla ,south,0.7291,455115,659685,325538,334147,5849640000,2385190000,3464450000
2019-09-01,Phang Nga ,south,0.44409999999999994,75322,250752,88895,161857,2490100000,319840000,2170260000
2019-09-01,Surat Thani ,south,0.6895,474198,541506,202264,339242,7586830000,1438290000,6148540000
2019-09-01,Satun ,south,0.3926,47319,78963,72975,5988,267080000,244040000,23040000
2019-09-01,Kamphaeng Phet ,north,0.3674,24923,42448,41204,1244,75320000,73530000,1790000
2019-09-01,Chiang Rai ,north,0.4697,212502,239470,185794,53676,1936900000,1367960000,568940000
2019-09-01,Chiang Mai ,north,0.616,563755,612667,348870,263797,6826610000,3197230000,3629380000
2019-09-01,Phichit ,north,0.473,33608,82181,81840,341,114300000,113940000,360000
2019-09-01,Nakhon Sawan ,north,0.45740000000000003,65829,97442,95617,1825,185560000,182490000,3070000
2019-09-01,Tak ,north,0.4813,92265,115534,111602,3932,378890000,369220000,9670000
2019-09-01,Phitsanulok ,north,0.5149,134840,211258,199810,11448,491290000,453930000,37360000
2019-09-01,Phayao ,north,0.38409999999999994,17387,48246,46744,1502,110580000,108640000,1940000
2019-09-01,Phetchabun ,north,0.4765,125447,149633,147757,1876,411480000,403920000,7560000
2019-09-01,Phrae ,north,0.4359,28105,64103,60732,3371,122080000,114220000,7860000
2019-09-01,Lampang ,north,0.4756,34930,88290,81280,7010,274670000,253620000,21050000
2019-09-01,Lamphun ,north,0.44299999999999995,16109,77567,75499,2068,85050000,83150000,1900000
2019-09-01,Mae Hong Son ,north,0.2982,40667,41744,27459,14285,211640000,104900000,106740000
2019-09-01,Uttaradit ,north,0.4018,31725,66619,65807,812,141540000,140460000,1080000
2019-09-01,Uthai Thani ,north,0.4236,24768,45582,45140,442,82100000,80680000,1420000
2019-09-01,Sukhothai ,north,0.4882,55767,81751,53800,27951,189610000,110530000,79080000
2019-09-01,Nan ,north,0.47609999999999997,40663,52010,50719,1291,129470000,125120000,4350000
2019-09-01,Kalasin ,east_northeast,0.49369999999999997,18557,80545,80238,307,114380000,113780000,600000
2019-09-01,Khon Kaen ,east_northeast,0.5624,197299,342015,332997,9018,1279530000,1247900000,31630000
2019-09-01,Chaiyaphum ,east_northeast,0.6591,90970,226328,225627,701,213920000,212200000,1720000
2019-09-01,Nakhon Phanom ,east_northeast,0.5820000000000001,36337,92179,86614,5565,171010000,163050000,7960000
2019-09-01,Nakhon Ratchasima ,east_northeast,0.6607,451322,803169,790028,13141,2180310000,2124240000,56070000
2019-09-01,Buriram ,east_northeast,0.4943,77493,124356,121023,3333,226340000,221120000,5220000
2019-09-01,Maha Sarakham ,east_northeast,0.43450000000000005,33691,54719,54077,642,64630000,63830000,800000
2019-09-01,Mukdahan ,east_northeast,0.5648,42619,166741,152291,14450,309430000,278250000,31180000
2019-09-01,Roi Et ,east_northeast,0.4243,35049,64079,63834,245,108320000,107920000,400000
2019-09-01,Loei ,east_northeast,0.4714,72921,146310,142799,3511,292140000,282750000,9390000
2019-09-01,Sisaket ,south,0.5433,29785,107937,106194,1743,127610000,122920000,4690000
2019-09-01,Surin ,east_northeast,0.48460000000000003,75889,99069,97710,1359,177150000,173590000,3560000
2019-09-01,Nong Khai ,east_northeast,0.5931000000000001,90451,184903,138293,46610,409140000,344760000,64380000
2019-09-01,Bueng Kan ,east_northeast,0.4768,20940,35107,34624,483,64400000,63230000,1170000
2019-09-01,Udon Thani ,east_northeast,0.6879000000000001,173269,321992,305434,16558,994690000,944150000,50540000
2019-09-01,Ubon Ratchathani ,east_northeast,0.31920000000000004,68283,116364,107295,9069,290960000,259520000,31440000
2019-09-01,Sakon Nakhon ,east_northeast,0.5339,48805,96605,96138,467,168430000,167640000,790000
2019-09-01,Yasothon ,east_northeast,0.4104,14471,45487,44488,999,44570000,42540000,2030000
2019-09-01,Amnat Charoen ,east_northeast,0.4202,6886,18453,17752,701,19500000,17470000,2030000
2019-09-01,Nong Bua Lamphu ,east_northeast,0.4482,11544,25048,24976,72,26990000,26890000,100000
2019-10-01,Bangkok,central,0.7515000000000001,2934737,5406264,3908924,1497340,87753820000,27781570000,59972250000
2019-10-01,Lopburi ,central,0.5839,58059,341859,339686,2173,572330000,568920000,3410000
2019-10-01,Phra Nakhon Si Ayutthaya ,central,0.5692,84926,660376,506881,153495,1718340000,1205750000,512590000
2019-10-01,Saraburi ,central,0.5887,96603,530592,516993,13599,963330000,929430000,33900000
2019-10-01,Chainat ,central,0.6487999999999999,22319,58103,57830,273,106740000,106230000,510000
2019-10-01,Nakhon Pathom ,central,0.6284000000000001,105472,378287,370289,7998,627160000,597120000,30040000
2019-10-01,Sing Buri ,central,0.5243,12324,37380,37163,217,81070000,80640000,430000
2019-10-01,Ang Thong ,central,0.5941,12656,54723,53523,1200,63920000,62660000,1260000
2019-10-01,Nonthaburi ,central,0.5532,73200,173270,156145,17125,312150000,276240000,35910000
2019-10-01,Pathum Thani ,central,0.52,52689,166909,124810,42099,318430000,212440000,105990000
2019-10-01,Samut Prakan ,central,0.5671,83806,190964,134323,56641,459540000,262040000,197500000
2019-10-01,Samut Sakhon ,central,0.5452,52029,194451,193974,477,361030000,360130000,900000
2019-10-01,Chachoengsao ,east,0.5212,39094,306601,302219,4382,497650000,489800000,7850000
2019-10-01,Ratchaburi ,central,0.529,91879,166283,159257,7026,346470000,329890000,16580000
2019-10-01,Kanchanaburi ,central,0.7193999999999999,276204,830182,792077,38105,2352780000,2189300000,163480000
2019-10-01,Samut Songkhram ,central,0.6147,80250,205318,199618,5700,270870000,263110000,7760000
2019-10-01,Suphan Buri ,central,0.773,101711,474403,471179,3224,708320000,702090000,6230000
2019-10-01,Phetchaburi ,central,0.6322,319231,883043,829202,53841,3440290000,3083130000,357160000
2019-10-01,Prachuap Khiri Khan ,central,0.62,417373,705632,567402,138230,4462430000,3080080000,1382350000
2019-10-01,Chonburi ,east,0.7537,1220788,1608024,710207,897817,26961650000,5225050000,21736600000
2019-10-01,Chanthaburi ,east,0.5468,142775,190414,184123,6291,615320000,587530000,27790000
2019-10-01,Trat ,east,0.6462,158830,186121,139965,46156,1681380000,965530000,715850000
2019-10-01,Nakhon Nayok ,east,0.5824,127806,243912,240726,3186,537170000,522570000,14600000
2019-10-01,Prachinburi ,east,0.5045000000000001,79860,138975,126770,12205,423490000,361110000,62380000
2019-10-01,Rayong ,east,0.6147,309859,662422,620219,42203,4142750000,3657260000,485490000
2019-10-01,Sa Kaeo ,east,0.5246999999999999,64487,187883,165165,22718,591750000,538340000,53410000
2019-10-01,Phuket ,south,0.6709,1007467,1156536,316689,839847,41618550000,3737340000,37881210000
2019-10-01,Phatthalung ,south,0.6102000000000001,72785,225473,224536,937,410430000,407930000,2500000
2019-10-01,Trang ,south,0.6486,95129,146167,126799,19368,751750000,572290000,179460000
2019-10-01,Ranong ,south,0.5607,63762,74448,70661,3787,286730000,267000000,19730000
2019-10-01,Chumphon ,south,0.4607,82520,102466,96846,5620,554510000,510380000,44130000
2019-10-01,Pattani ,south,0.452,18073,22540,22358,182,75030000,74170000,860000
2019-10-01,Yala ,south,0.4855,57186,65023,18730,46293,302990000,61230000,241760000
2019-10-01,Nakhon Si Thammarat ,south,0.5197999999999999,185615,269000,263721,5279,1164290000,1134990000,29300000
2019-10-01,Narathiwat ,south,0.4941,45482,49253,20038,29215,191790000,69730000,122060000
2019-10-01,Krabi ,south,0.6409,348201,550474,195162,355312,10158900000,3354650000,6804250000
2019-10-01,Songkhla ,south,0.6951999999999999,446192,576867,350855,226012,4948430000,2470040000,2478390000
2019-10-01,Phang Nga ,south,0.6456999999999999,119352,506469,209537,296932,5004570000,760960000,4243610000
2019-10-01,Surat Thani ,south,0.5638000000000001,380032,446040,188851,257189,7257010000,1400090000,5856920000
2019-10-01,Satun ,south,0.49810000000000004,70618,116331,100431,15900,585490000,483920000,101570000
2019-10-01,Kamphaeng Phet ,north,0.45530000000000004,40215,74662,73391,1271,163650000,160880000,2770000
2019-10-01,Chiang Rai ,north,0.526,251051,312230,263703,48527,2739990000,2172340000,567650000
2019-10-01,Chiang Mai ,north,0.7065,674966,1099218,829611,269607,10083650000,6975840000,3107810000
2019-10-01,Phichit ,north,0.4978,35921,83280,82808,472,155410000,154140000,1270000
2019-10-01,Nakhon Sawan ,north,0.47840000000000005,75284,139838,138051,1787,331530000,324400000,7130000
2019-10-01,Tak ,north,0.5753,137167,172685,168937,3748,605860000,581270000,24590000
2019-10-01,Phitsanulok ,north,0.5709000000000001,158207,265869,238548,27321,820190000,714130000,106060000
2019-10-01,Phayao ,north,0.45020000000000004,28522,59929,56986,2943,143290000,137410000,5880000
2019-10-01,Phetchabun ,north,0.6009,206723,228211,226166,2045,765620000,758640000,6980000
2019-10-01,Phrae ,north,0.5118,35588,82021,75190,6831,168790000,157210000,11580000
2019-10-01,Lampang ,north,0.5886,54704,152819,137453,15366,518480000,437280000,81200000
2019-10-01,Lamphun ,north,0.5078,20753,110703,105107,5596,160500000,152770000,7730000
2019-10-01,Mae Hong Son ,north,0.5091,107763,110983,86583,24400,514760000,342700000,172060000
2019-10-01,Uttaradit ,north,0.4814,61260,85577,84829,748,154700000,153430000,1270000
2019-10-01,Uthai Thani ,north,0.4789,29891,68234,67706,528,134600000,133230000,1370000
2019-10-01,Sukhothai ,north,0.5924,86569,132725,101734,30991,433400000,350700000,82700000
2019-10-01,Nan ,north,0.5367999999999999,62008,76125,74050,2075,194720000,183080000,11640000
2019-10-01,Kalasin ,east_northeast,0.57,23571,64655,64376,279,107990000,107030000,960000
2019-10-01,Khon Kaen ,east_northeast,0.5481,162261,495441,491543,3898,1669820000,1656050000,13770000
2019-10-01,Chaiyaphum ,east_northeast,0.5764,82871,124898,124384,514,197200000,195490000,1710000
2019-10-01,Nakhon Phanom ,east_northeast,0.5445,37510,99663,92847,6816,163370000,154220000,9150000
2019-10-01,Nakhon Ratchasima ,east_northeast,0.7954000000000001,566348,929863,912701,17162,2282270000,2220160000,62110000
2019-10-01,Buriram ,east_northeast,0.9586,187138,407861,370545,37316,1116900000,896090000,220810000
2019-10-01,Maha Sarakham ,east_northeast,0.4439,33894,63894,63316,578,97820000,96080000,1740000
2019-10-01,Mukdahan ,east_northeast,0.5241,41337,164929,150942,13987,275400000,245120000,30280000
2019-10-01,Roi Et ,east_northeast,0.48560000000000003,37628,98035,97608,427,159690000,158830000,860000
2019-10-01,Loei ,east_northeast,0.5759000000000001,109871,195162,191484,3678,411890000,399840000,12050000
2019-10-01,Sisaket ,south,0.5592,32356,89701,88441,1260,138890000,135720000,3170000
2019-10-01,Surin ,east_northeast,0.7311,118542,163290,144967,18323,397150000,356370000,40780000
2019-10-01,Nong Khai ,east_northeast,0.6539,96036,258047,217080,40967,494830000,439000000,55830000
2019-10-01,Bueng Kan ,east_northeast,0.5882000000000001,30173,55184,54708,476,90640000,89840000,800000
2019-10-01,Udon Thani ,east_northeast,0.7075,174153,399892,385264,14628,1116390000,1071650000,44740000
2019-10-01,Ubon Ratchathani ,east_northeast,0.5972,126455,330733,320688,10045,687760000,652200000,35560000
2019-10-01,Sakon Nakhon ,east_northeast,0.5439,59218,119349,118961,388,178270000,177360000,910000
2019-10-01,Yasothon ,east_northeast,0.47909999999999997,14914,44413,43511,902,51150000,48330000,2820000
2019-10-01,Amnat Charoen ,east_northeast,0.6043999999999999,9898,39242,38575,667,61440000,58420000,3020000
2019-10-01,Nong Bua Lamphu ,east_northeast,0.5379999999999999,13588,39971,39811,160,42110000,41960000,150000
2019-11-01,Bangkok,central,0.8107,3039784,5620260,4087756,1532504,90433220000,29052570000,61380650000
2019-11-01,Lopburi ,central,0.6352,61855,364187,361821,2366,609700000,605990000,3710000
2019-11-01,Phra Nakhon Si Ayutthaya ,central,0.6067,87169,678016,514770,163246,1769650000,1224510000,545140000
2019-11-01,Saraburi ,central,0.5837,95772,524701,510218,14483,953350000,917250000,36100000
2019-11-01,Chainat ,central,0.7082999999999999,22758,59235,59021,214,108810000,108410000,400000
2019-11-01,Nakhon Pathom ,central,0.6518999999999999,106895,383934,376239,7695,635620000,606720000,28900000
2019-11-01,Sing Buri ,central,0.5533,12077,36630,36490,140,79460000,79180000,280000
2019-11-01,Ang Thong ,central,0.5266,10564,45551,44704,847,53220000,52330000,890000
2019-11-01,Nonthaburi ,central,0.6623,90673,213904,198289,15615,383550000,350800000,32750000
2019-11-01,Pathum Thani ,central,0.5738,54862,171277,131982,39295,323580000,224650000,98930000
2019-11-01,Samut Prakan ,central,0.639,96402,220742,157984,62758,527020000,308190000,218830000
2019-11-01,Samut Sakhon ,central,0.5103,53571,200211,199708,503,371710000,370770000,940000
2019-11-01,Chachoengsao ,east,0.5398,40612,318879,315214,3665,517440000,510870000,6570000
2019-11-01,Ratchaburi ,central,0.5928,98012,177304,169921,7383,369400000,351980000,17420000
2019-11-01,Kanchanaburi ,central,0.7926000000000001,322062,967924,923982,43942,2742410000,2553880000,188530000
2019-11-01,Samut Songkhram ,central,0.6954,91689,234731,228017,6714,309690000,300550000,9140000
2019-11-01,Suphan Buri ,central,0.8031,106474,496323,492372,3951,741300000,733670000,7630000
2019-11-01,Phetchaburi ,central,0.6211,306354,844099,785907,58192,3308180000,2922150000,386030000
2019-11-01,Prachuap Khiri Khan ,central,0.6478,432497,735777,602382,133395,4603970000,3269970000,1334000000
2019-11-01,Chonburi ,east,0.8312999999999999,1319409,1782680,883767,898913,28265070000,6501940000,21763130000
2019-11-01,Chanthaburi ,east,0.5216,132847,177500,169992,7508,575610000,542440000,33170000
2019-11-01,Trat ,east,0.6297999999999999,153704,180003,131056,48947,1663220000,904080000,759140000
2019-11-01,Nakhon Nayok ,east,0.6046,121675,231927,227993,3934,512960000,494930000,18030000
2019-11-01,Prachinburi ,east,0.5364,81485,142085,130449,11636,431070000,371590000,59480000
2019-11-01,Rayong ,east,0.6493000000000001,334314,714492,668646,45846,4470230000,3942830000,527400000
2019-11-01,Sa Kaeo ,east,0.5428999999999999,61306,182713,155533,27180,570850000,506950000,63900000
2019-11-01,Phuket ,south,0.7612000000000001,963468,1106035,302965,803070,39797790000,3575380000,36222410000
2019-11-01,Phatthalung ,south,0.56,63971,198123,197229,894,360700000,358320000,2380000
2019-11-01,Trang ,south,0.6448999999999999,93115,142995,123754,19241,736840000,558550000,178290000
2019-11-01,Ranong ,south,0.5705,64724,75549,71810,3739,290820000,271340000,19480000
2019-11-01,Chumphon ,south,0.5272,81839,101638,94766,6872,553370000,499410000,53960000
2019-11-01,Pattani ,south,0.45520000000000005,18901,23566,23318,248,78520000,77350000,1170000
2019-11-01,Yala ,south,0.4045,51323,58474,12062,46412,281810000,39430000,242380000
2019-11-01,Nakhon Si Thammarat ,south,0.4747,171935,249861,241949,7912,1085190000,1041290000,43900000
2019-11-01,Narathiwat ,south,0.46399999999999997,45243,49006,20745,28261,190270000,72190000,118080000
2019-11-01,Krabi ,south,0.6809000000000001,334303,535086,162062,373024,9929130000,2785700000,7143430000
2019-11-01,Songkhla ,south,0.6984,455924,578232,317401,260831,5094720000,2234520000,2860200000
2019-11-01,Phang Nga ,south,0.6884,110385,460596,156270,304326,4916800000,567520000,4349280000
2019-11-01,Surat Thani ,south,0.49340000000000006,321592,378375,163608,214767,6103790000,1212940000,4890850000
2019-11-01,Satun ,south,0.6391,71919,118420,102754,15666,595180000,495110000,100070000
2019-11-01,Kamphaeng Phet ,north,0.5314,46256,86028,84092,1936,188560000,184340000,4220000
2019-11-01,Chiang Rai ,north,0.6534,302293,375804,316233,59571,3301920000,2605080000,696840000
2019-11-01,Chiang Mai ,north,0.8281000000000001,774996,1249167,906939,342228,11570980000,7626060000,3944920000
2019-11-01,Phichit ,north,0.4753,34967,81072,80695,377,151220000,150210000,1010000
2019-11-01,Nakhon Sawan ,north,0.5075999999999999,81894,152038,149956,2082,360680000,352370000,8310000
2019-11-01,Tak ,north,0.7389,166042,209008,204805,4203,732260000,704680000,27580000
2019-11-01,Phitsanulok ,north,0.5672999999999999,157276,264006,235025,28981,816100000,703590000,112510000
2019-11-01,Phayao ,north,0.4829,31411,66069,62709,3360,157920000,151210000,6710000
2019-11-01,Phetchabun ,north,0.6920999999999999,236869,261616,258945,2671,877720000,868600000,9120000
2019-11-01,Phrae ,north,0.5449,38308,88622,80696,7926,182160000,168720000,13440000
2019-11-01,Lampang ,north,0.6829999999999999,64867,181349,162651,18698,616260000,517450000,98810000
2019-11-01,Lamphun ,north,0.5714,24251,129109,123131,5978,187230000,178970000,8260000
2019-11-01,Mae Hong Son ,north,0.6405,129692,133567,108996,24571,604670000,431410000,173260000
2019-11-01,Uttaradit ,north,0.5406,73118,102078,101410,668,184570000,183430000,1140000
2019-11-01,Uthai Thani ,north,0.5378000000000001,34094,77841,77300,541,153510000,152110000,1400000
2019-11-01,Sukhothai ,north,0.6786,97417,149820,113028,36792,487820000,389640000,98180000
2019-11-01,Nan ,north,0.5611999999999999,67483,82790,80790,2000,210960000,199740000,11220000
2019-11-01,Kalasin ,east_northeast,0.5056,20873,57252,57016,236,95600000,94790000,810000
2019-11-01,Khon Kaen ,east_northeast,0.5981000000000001,169690,518349,514733,3616,1746950000,1734180000,12770000
2019-11-01,Chaiyaphum ,east_northeast,0.5677,79618,119964,119328,636,189660000,187540000,2120000
2019-11-01,Nakhon Phanom ,east_northeast,0.5345,35896,95358,88853,6505,156320000,147590000,8730000
2019-11-01,Nakhon Ratchasima ,east_northeast,0.7101999999999999,464697,763235,746232,17003,1876750000,1815220000,61530000
2019-11-01,Buriram ,east_northeast,0.5051,86220,193261,191700,1561,472820000,463590000,9230000
2019-11-01,Maha Sarakham ,east_northeast,0.48119999999999996,35834,67556,67008,548,103330000,101680000,1650000
2019-11-01,Mukdahan ,east_northeast,0.524,40044,161262,145406,15856,270460000,236130000,34330000
2019-11-01,Roi Et ,east_northeast,0.4372,31627,82391,82056,335,134200000,133520000,680000
2019-11-01,Loei ,east_northeast,0.6998000000000001,124336,221021,216320,4701,467090000,451700000,15390000
2019-11-01,Sisaket ,south,0.5164,29274,81130,79902,1228,125710000,122620000,3090000
2019-11-01,Surin ,east_northeast,0.6773,99900,132913,129376,3537,325920000,318050000,7870000
2019-11-01,Nong Khai ,east_northeast,0.6015999999999999,86834,233874,196156,37718,448080000,396680000,51400000
2019-11-01,Bueng Kan ,east_northeast,0.6096,30572,56076,55366,710,92110000,90920000,1190000
2019-11-01,Udon Thani ,east_northeast,0.6739,161082,369747,356617,13130,1032120000,991960000,40160000
2019-11-01,Ubon Ratchathani ,east_northeast,0.5975,124724,326592,317483,9109,677930000,645680000,32250000
2019-11-01,Sakon Nakhon ,east_northeast,0.5556,58802,118513,118117,396,177020000,176100000,920000
2019-11-01,Yasothon ,east_northeast,0.5146999999999999,15326,45637,44708,929,52560000,49660000,2900000
2019-11-01,Amnat Charoen ,east_northeast,0.5754,9432,37148,36356,792,58640000,55060000,3580000
2019-11-01,Nong Bua Lamphu ,east_northeast,0.5392,14246,42038,41668,370,44250000,43920000,330000
2019-12-01,Bangkok,central,0.8581,3335728,5677271,3554429,2122842,110287280000,25262080000,85025200000
2019-12-01,Lopburi ,central,0.6467,62532,368325,366251,2074,616680000,613420000,3260000
2019-12-01,Phra Nakhon Si Ayutthaya ,central,0.6552,98062,762589,583381,179208,1986150000,1387710000,598440000
2019-12-01,Saraburi ,central,0.5999,98573,537614,520872,16742,978170000,936420000,41750000
2019-12-01,Chainat ,central,0.7401000000000001,24993,65106,64544,562,119620000,118580000,1040000
2019-12-01,Nakhon Pathom ,central,0.6648999999999999,109180,390296,381032,9264,649230000,614420000,34810000
2019-12-01,Sing Buri ,central,0.5700999999999999,13124,39806,39547,259,86320000,85800000,520000
2019-12-01,Ang Thong ,central,0.5494,11991,51880,50703,1177,60580000,59370000,1210000
2019-12-01,Nonthaburi ,central,0.6554000000000001,88480,209049,191367,17682,375620000,338540000,37080000
2019-12-01,Pathum Thani ,central,0.654,64010,200618,153364,47254,380050000,261060000,118990000
2019-12-01,Samut Prakan ,central,0.6735,99259,225331,156369,68962,545500000,305040000,240460000
2019-12-01,Samut Sakhon ,central,0.4953,51444,192245,191708,537,356910000,355920000,990000
2019-12-01,Chachoengsao ,east,0.49810000000000004,37466,293910,289895,4015,477010000,469810000,7200000
2019-12-01,Ratchaburi ,central,0.6542,109829,199450,190070,9380,415860000,393710000,22150000
2019-12-01,Kanchanaburi ,central,0.8506,324550,975245,931789,43456,2761910000,2575450000,186460000
2019-12-01,Samut Songkhram ,central,0.7045999999999999,97734,249757,243223,6534,329480000,320580000,8900000
2019-12-01,Suphan Buri ,central,0.8020999999999999,100006,466214,462585,3629,696280000,689270000,7010000
2019-12-01,Phetchaburi ,central,0.7137,377609,1049177,994621,54556,4060070000,3698170000,361900000
2019-12-01,Prachuap Khiri Khan ,central,0.4836,493313,848254,715505,132749,5211550000,3884030000,1327520000
2019-12-01,Chonburi ,east,0.8438,1270383,1715784,849229,866555,27172990000,6247840000,20925150000
2019-12-01,Chanthaburi ,east,0.5839,145003,193495,186546,6949,625960000,595250000,30710000
2019-12-01,Trat ,east,0.6585,170268,199433,146422,53011,1833460000,1010080000,823380000
2019-12-01,Nakhon Nayok ,east,0.5938,125172,238714,235053,3661,527030000,510250000,16780000
2019-12-01,Prachinburi ,east,0.5528,84927,147991,135584,12407,449640000,386220000,63420000
2019-12-01,Rayong ,east,0.6578,332269,707029,656839,50190,4450590000,3873210000,577380000
2019-12-01,Sa Kaeo ,east,0.5815,70987,210384,180521,29863,658610000,588400000,70210000
2019-12-01,Phuket ,south,0.8268000000000001,1406031,1619537,511851,1107686,56002560000,6040510000,49962050000
2019-12-01,Phatthalung ,south,0.6288,58461,180987,180064,923,329600000,327150000,2450000
2019-12-01,Trang ,south,0.6715000000000001,85793,130411,107799,22612,696050000,486530000,209520000
2019-12-01,Ranong ,south,0.6029,64372,75000,71934,3066,287780000,271810000,15970000
2019-12-01,Chumphon ,south,0.5486,90924,112928,104724,8204,616330000,551890000,64440000
2019-12-01,Pattani ,south,0.5054,19236,23980,23688,292,79960000,78580000,1380000
2019-12-01,Yala ,south,0.44380000000000003,46519,52901,14943,37958,247090000,48870000,198220000
2019-12-01,Nakhon Si Thammarat ,south,0.5672999999999999,192991,280275,272212,8063,1216290000,1171540000,44750000
2019-12-01,Narathiwat ,south,0.5052,48920,52957,20043,32914,207250000,69740000,137510000
2019-12-01,Krabi ,south,0.8676999999999999,487292,777417,246006,531411,14405140000,4228610000,10176530000
2019-12-01,Songkhla ,south,0.664,460147,583218,318983,264235,5143210000,2245670000,2897540000
2019-12-01,Phang Nga ,south,0.7252,110949,454240,115271,338969,5262980000,418610000,4844370000
2019-12-01,Surat Thani ,south,0.7145999999999999,459926,527901,179626,348275,9262900000,1331720000,7931180000
2019-12-01,Satun ,south,0.6518,74817,123245,106434,16811,620220000,512830000,107390000
2019-12-01,Kamphaeng Phet ,north,0.6156,55016,102159,100365,1794,223930000,220000000,3930000
2019-12-01,Chiang Rai ,north,0.7689,378014,470773,402394,68379,4114750000,3314860000,799890000
2019-12-01,Chiang Mai ,north,0.9186,933415,1525574,1166487,359087,13947740000,9808490000,4139250000
2019-12-01,Phichit ,north,0.5184000000000001,39137,90747,90439,308,169170000,168330000,840000
2019-12-01,Nakhon Sawan ,north,0.5745,93206,173241,171236,2005,410370000,402360000,8010000
2019-12-01,Tak ,north,0.7328,174094,219094,215263,3831,765820000,740680000,25140000
2019-12-01,Phitsanulok ,north,0.6256,178176,299764,271069,28695,922890000,811490000,111400000
2019-12-01,Phayao ,north,0.5596,36532,76660,73055,3605,183370000,176170000,7200000
2019-12-01,Phetchabun ,north,0.7645000000000001,272449,300757,298092,2665,1009010000,999920000,9090000
2019-12-01,Phrae ,north,0.6426000000000001,45280,104166,95806,8360,214480000,200320000,14160000
2019-12-01,Lampang ,north,0.7106999999999999,67662,188844,170433,18411,639520000,542220000,97300000
2019-12-01,Lamphun ,north,0.6459,27613,147076,140117,6959,213290000,203670000,9620000
2019-12-01,Mae Hong Son ,north,0.743,157667,162377,135647,26730,724750000,536880000,187870000
2019-12-01,Uttaradit ,north,0.5794,78401,109443,108767,676,197860000,196720000,1140000
2019-12-01,Uthai Thani ,north,0.5267000000000001,33635,76788,76235,553,151440000,150030000,1410000
2019-12-01,Sukhothai ,north,0.7164,106945,162493,130293,32200,535070000,449140000,85930000
2019-12-01,Nan ,north,0.6375,75556,92719,90360,2359,236620000,223380000,13240000
2019-12-01,Kalasin ,east_northeast,0.5333,21723,59602,59278,324,99640000,98540000,1100000
2019-12-01,Khon Kaen ,east_northeast,0.5582,169406,516909,512127,4782,1742300000,1725400000,16900000
2019-12-01,Chaiyaphum ,east_northeast,0.5835,84805,127751,126952,799,202200000,199530000,2670000
2019-12-01,Nakhon Phanom ,east_northeast,0.5436,36039,97449,89075,8374,159190000,147950000,11240000
2019-12-01,Nakhon Ratchasima ,east_northeast,0.7437999999999999,496562,815509,798020,17489,2004770000,1941200000,63570000
2019-12-01,Buriram ,east_northeast,0.5670000000000001,95436,213801,211726,2075,524310000,512020000,12290000
2019-12-01,Maha Sarakham ,east_northeast,0.4648,35432,66783,65963,820,102530000,100080000,2450000
2019-12-01,Mukdahan ,east_northeast,0.5474,43001,173174,156142,17032,290450000,253570000,36880000
2019-12-01,Roi Et ,east_northeast,0.4537,33917,88355,87994,361,143890000,143170000,720000
2019-12-01,Loei ,east_northeast,0.8654999999999999,156751,278587,272838,5749,588540000,569710000,18830000
2019-12-01,Sisaket ,south,0.6222,33851,93778,92236,1542,145450000,141550000,3900000
2019-12-01,Surin ,east_northeast,0.6053000000000001,91993,122385,119147,3238,300090000,292890000,7200000
2019-12-01,Nong Khai ,east_northeast,0.7020000000000001,103353,284198,232175,52023,540420000,469530000,70890000
2019-12-01,Bueng Kan ,east_northeast,0.633,31567,57856,57185,671,95040000,93910000,1130000
2019-12-01,Udon Thani ,east_northeast,0.7181000000000001,178173,410047,392245,17802,1145510000,1091080000,54430000
2019-12-01,Ubon Ratchathani ,east_northeast,0.6656,141430,370190,359560,10630,768880000,731260000,37620000
2019-12-01,Sakon Nakhon ,east_northeast,0.562,61950,124903,124354,549,186710000,185410000,1300000
2019-12-01,Yasothon ,east_northeast,0.5439,16623,49297,48156,1141,57060000,53480000,3580000
2019-12-01,Amnat Charoen ,east_northeast,0.6516,10574,41764,40949,815,65680000,62010000,3670000
2019-12-01,Nong Bua Lamphu ,east_northeast,0.6064,15642,46115,45772,343,48550000,48250000,300000
2020-01-01,Bangkok,central,0.8936,3213765,6046765,3573040,2473725,88202890000,31137650000,57065240000
2020-01-01,Lopburi ,central,0.5153,39765,242413,240280,2133,413570000,408580000,4990000
2020-01-01,Phra Nakhon Si Ayutthaya ,central,0.6607,107777,741902,556141,185761,1462740000,1059240000,403500000
2020-01-01,Saraburi ,central,0.5971,81682,195397,189741,5656,321860000,310280000,11580000
2020-01-01,Chainat ,central,0.7347,23128,72893,72380,513,91930000,91090000,840000
2020-01-01,Nakhon Pathom ,central,0.6463,109852,272110,261231,10879,380900000,365850000,15050000
2020-01-01,Sing Buri ,central,0.5793,13873,43540,43326,214,61740000,61400000,340000
2020-01-01,Ang Thong ,central,0.6396999999999999,16084,97978,93280,4698,125870000,120590000,5280000
2020-01-01,Nonthaburi ,central,0.711,83049,308136,280170,27966,469040000,385540000,83500000
2020-01-01,Pathum Thani ,central,0.5863,50824,238331,174404,63927,312310000,208060000,104250000
2020-01-01,Samut Prakan ,central,0.6955,86797,399020,202234,196786,745260000,303530000,441730000
2020-01-01,Samut Sakhon ,central,0.5837,55591,101472,101051,421,167130000,166410000,720000
2020-01-01,Chachoengsao ,east,0.5542,36156,268543,264901,3642,296470000,291730000,4740000
2020-01-01,Ratchaburi ,central,0.7278,84723,239500,235148,4352,449360000,439390000,9970000
2020-01-01,Kanchanaburi ,central,0.8192,329862,770371,725543,44828,2754660000,2505210000,249450000
2020-01-01,Samut Songkhram ,central,0.6951999999999999,59982,190391,186751,3640,328850000,321900000,6950000
2020-01-01,Suphan Buri ,central,0.8581,86973,223794,222232,1562,469100000,466670000,2430000
2020-01-01,Phetchaburi ,central,0.726,326049,654478,589759,64719,2234230000,1704790000,529440000
2020-01-01,Prachuap Khiri Khan ,central,0.7034999999999999,341491,576227,460687,115540,3509890000,2376060000,1133830000
2020-01-01,Chonburi ,east,0.8321,1329662,1585782,615982,969800,27064450000,3927710000,23136740000
2020-01-01,Chanthaburi ,east,0.7636,126987,300501,293389,7112,1000640000,950740000,49900000
2020-01-01,Trat ,east,0.7226,184137,198359,126273,72086,1901570000,826180000,1075390000
2020-01-01,Nakhon Nayok ,east,0.5986,125509,265162,262943,2219,809670000,803890000,5780000
2020-01-01,Prachinburi ,east,0.6712,87087,168750,157814,10936,490400000,456380000,34020000
2020-01-01,Rayong ,east,0.6573,359238,617597,553520,64077,2366440000,1946110000,420330000
2020-01-01,Sa Kaeo ,east,0.4925,68404,193291,162445,30846,580400000,489950000,90450000
2020-01-01,Phuket ,south,0.8771,1524977,1722034,316150,1405884,62468600000,4450200000,58018400000
2020-01-01,Phatthalung ,south,0.6753,65735,121873,121018,855,183610000,180930000,2680000
2020-01-01,Trang ,south,0.6759999999999999,125148,165681,142629,23052,1236730000,1019800000,216930000
2020-01-01,Ranong ,south,0.528,81465,106008,99216,6792,369340000,323260000,46080000
2020-01-01,Chumphon ,south,0.5898,90484,115989,105692,10297,509710000,459710000,50000000
2020-01-01,Pattani ,south,0.4572,16725,20886,20742,144,77570000,76930000,640000
2020-01-01,Yala ,south,0.4836,46228,49911,8873,41038,227800000,35240000,192560000
2020-01-01,Nakhon Si Thammarat ,south,0.5604,222969,353316,343329,9987,1182120000,1148460000,33660000
2020-01-01,Narathiwat ,south,0.6039,50224,61030,22468,38562,229420000,61390000,168030000
2020-01-01,Krabi ,south,0.7951,338142,567726,181672,386054,12505300000,3017750000,9487550000
2020-01-01,Songkhla ,south,0.8205,455523,827668,543218,284450,7356250000,3896670000,3459580000
2020-01-01,Phang Nga ,south,0.8523999999999999,110362,499591,138124,361467,6156910000,861820000,5295090000
2020-01-01,Surat Thani ,south,0.691,444734,491605,156940,334665,9852870000,1172060000,8680810000
2020-01-01,Satun ,south,0.7277,79526,194605,175636,18969,1659280000,1563930000,95350000
2020-01-01,Kamphaeng Phet ,north,0.5372,43616,71963,69852,2111,150350000,143630000,6720000
2020-01-01,Chiang Rai ,north,0.7829999999999999,392547,436005,373814,62191,3077950000,2547250000,530700000
2020-01-01,Chiang Mai ,north,0.8532,822663,1047546,737588,309958,11087860000,6950680000,4137180000
2020-01-01,Phichit ,north,0.5408,45232,61863,61293,570,133460000,132540000,920000
2020-01-01,Nakhon Sawan ,north,0.6179,116065,189972,183682,6290,350350000,341970000,8380000
2020-01-01,Tak ,north,0.7573000000000001,179957,238235,232580,5655,722110000,701820000,20290000
2020-01-01,Phitsanulok ,north,0.6901,192912,376176,353691,22485,971570000,898610000,72960000
2020-01-01,Phayao ,north,0.6644,31544,80242,76779,3463,148700000,144280000,4420000
2020-01-01,Phetchabun ,north,0.7211,199081,250520,248417,2103,872240000,866590000,5650000
2020-01-01,Phrae ,north,0.6912999999999999,35523,86488,77194,9294,186090000,152770000,33320000
2020-01-01,Lampang ,north,0.7229000000000001,64268,112377,102304,10073,327620000,276880000,50740000
2020-01-01,Lamphun ,north,0.6046,23987,110487,104315,6172,175830000,163980000,11850000
2020-01-01,Mae Hong Son ,north,0.6936,117691,126975,98387,28588,598940000,379010000,219930000
2020-01-01,Uttaradit ,north,0.6058,61478,122631,121682,949,251230000,249150000,2080000
2020-01-01,Uthai Thani ,north,0.4978,35301,83459,83146,313,139770000,138690000,1080000
2020-01-01,Sukhothai ,north,0.6686,80615,140701,100563,40138,322830000,192940000,129890000
2020-01-01,Nan ,north,0.8298000000000001,96325,115357,113177,2180,340880000,330100000,10780000
2020-01-01,Kalasin ,east_northeast,0.5042,20430,56432,55961,471,84660000,83670000,990000
2020-01-01,Khon Kaen ,east_northeast,0.5725,205657,521419,513809,7610,1653690000,1627700000,25990000
2020-01-01,Chaiyaphum ,east_northeast,0.6126,70023,130777,130071,706,178310000,176460000,1850000
2020-01-01,Nakhon Phanom ,east_northeast,0.6313,45236,101079,93957,7122,211070000,201520000,9550000
2020-01-01,Nakhon Ratchasima ,east_northeast,0.7336,498547,985403,965138,20265,2479920000,2386070000,93850000
2020-01-01,Buriram ,east_northeast,0.654,94359,159289,154482,4807,338490000,331540000,6950000
2020-01-01,Maha Sarakham ,east_northeast,0.5473,37569,62442,60865,1577,100770000,98780000,1990000
2020-01-01,Mukdahan ,east_northeast,0.6112,63536,194247,181131,13116,350120000,320790000,29330000
2020-01-01,Roi Et ,east_northeast,0.5869,42487,84003,83226,777,112930000,111290000,1640000
2020-01-01,Loei ,east_northeast,0.7231000000000001,122692,198483,195942,2541,448010000,438750000,9260000
2020-01-01,Sisaket ,south,0.6568999999999999,43025,183945,181515,2430,276730000,270580000,6150000
2020-01-01,Surin ,east_northeast,0.5811999999999999,89530,121634,118435,3199,310630000,300520000,10110000
2020-01-01,Nong Khai ,east_northeast,0.7008,119040,261226,189542,71684,560550000,461660000,98890000
2020-01-01,Bueng Kan ,east_northeast,0.7286,37457,66078,65801,277,138080000,137430000,650000
2020-01-01,Udon Thani ,east_northeast,0.8319,181587,285057,268125,16932,790750000,709880000,80870000
2020-01-01,Ubon Ratchathani ,east_northeast,0.715,135215,289283,272251,17032,926600000,846620000,79980000
2020-01-01,Sakon Nakhon ,east_northeast,0.6441,62304,113762,113368,394,233370000,232200000,1170000
2020-01-01,Yasothon ,east_northeast,0.5085000000000001,14569,48262,46756,1506,61580000,58380000,3200000
2020-01-01,Amnat Charoen ,east_northeast,0.5836,8260,21009,20220,789,33020000,31290000,1730000
2020-01-01,Nong Bua Lamphu ,east_northeast,0.5336,12416,32414,32272,142,34230000,34030000,200000
2020-02-01,Bangkok,central,0.6837000000000001,2388329,3525522,2259097,1266425,48826430000,18810390000,30016040000
2020-02-01,Lopburi ,central,0.522,35051,190373,188783,1590,319550000,315680000,3870000
2020-02-01,Phra Nakhon Si Ayutthaya ,central,0.5054,70417,375100,282929,92171,784140000,583790000,200350000
2020-02-01,Saraburi ,central,0.5091,62116,125859,123787,2072,215480000,211190000,4290000
2020-02-01,Chainat ,central,0.5898,18283,54383,54023,360,71640000,71040000,600000
2020-02-01,Nakhon Pathom ,central,0.6059,96051,195745,187142,8603,275720000,263330000,12390000
2020-02-01,Sing Buri ,central,0.5421,12417,35266,35109,157,50770000,50490000,280000
2020-02-01,Ang Thong ,central,0.593,13461,76997,73479,3518,103380000,99400000,3980000
2020-02-01,Nonthaburi ,central,0.5207999999999999,56271,188108,182633,5475,280470000,262990000,17480000
2020-02-01,Pathum Thani ,central,0.45399999999999996,38020,125549,116657,8892,159120000,144230000,14890000
2020-02-01,Samut Prakan ,central,0.4698,59573,189176,89213,99963,365530000,130510000,235020000
2020-02-01,Samut Sakhon ,central,0.6143,53604,84621,84329,292,144370000,143850000,520000
2020-02-01,Chachoengsao ,east,0.4251,26152,123664,122264,1400,143840000,142040000,1800000
2020-02-01,Ratchaburi ,central,0.5034000000000001,47897,124885,122819,2066,246030000,240900000,5130000
2020-02-01,Kanchanaburi ,central,0.5978,247674,546651,524705,21946,1941200000,1817810000,123390000
2020-02-01,Samut Songkhram ,central,0.6111,51832,159881,157065,2816,274580000,269280000,5300000
2020-02-01,Suphan Buri ,central,0.7195,69809,165744,164644,1100,343360000,341550000,1810000
2020-02-01,Phetchaburi ,central,0.6109,268846,531193,500721,30472,1704790000,1467890000,236900000
2020-02-01,Prachuap Khiri Khan ,central,0.5311,234637,389358,329446,59912,2338970000,1745550000,593420000
2020-02-01,Chonburi ,east,0.4607,583921,636605,329571,307034,9151210000,2213660000,6937550000
2020-02-01,Chanthaburi ,east,0.5705,95216,262355,257162,5193,880060000,843270000,36790000
2020-02-01,Trat ,east,0.6736,136968,148117,92557,55560,1409870000,598740000,811130000
2020-02-01,Nakhon Nayok ,east,0.5072,100645,201610,199829,1781,612170000,607280000,4890000
2020-02-01,Prachinburi ,east,0.46869999999999995,60975,108111,102019,6092,302750000,282730000,20020000
2020-02-01,Rayong ,east,0.5395,285075,457634,415288,42346,1772650000,1490330000,282320000
2020-02-01,Sa Kaeo ,east,0.4443,56015,140688,136056,4632,423800000,410960000,12840000
2020-02-01,Phuket ,south,0.5613,853419,889508,294633,594875,29126700000,4211590000,24915110000
2020-02-01,Phatthalung ,south,0.5848,54688,94205,93606,599,147340000,145350000,1990000
2020-02-01,Trang ,south,0.6338,108572,132492,110438,22054,995400000,776360000,219040000
2020-02-01,Ranong ,south,0.5767,77074,98829,92304,6525,354040000,308090000,45950000
2020-02-01,Chumphon ,south,0.4947,72786,90369,83511,6858,390600000,356780000,33820000
2020-02-01,Pattani ,south,0.4224,15457,19262,19015,247,73310000,72150000,1160000
2020-02-01,Yala ,south,0.2948,26959,28277,8288,19989,130140000,34110000,96030000
2020-02-01,Nakhon Si Thammarat ,south,0.514,153356,226500,218609,7891,806590000,778820000,27770000
2020-02-01,Narathiwat ,south,0.47130000000000005,44755,52071,25727,26344,192980000,72110000,120870000
2020-02-01,Krabi ,south,0.6485,333069,427837,209565,218272,9033430000,3630790000,5402640000
2020-02-01,Songkhla ,south,0.4771,262792,321741,224797,96944,2876970000,1624100000,1252870000
2020-02-01,Phang Nga ,south,0.6164000000000001,80645,258799,75732,183067,3437300000,470740000,2966560000
2020-02-01,Surat Thani ,south,0.6054999999999999,363612,365521,168436,197085,6620440000,1286600000,5333840000
2020-02-01,Satun ,south,0.6731999999999999,62626,143598,130525,13073,1180060000,1111310000,68750000
2020-02-01,Kamphaeng Phet ,north,0.45289999999999997,34780,55715,53773,1942,116620000,110250000,6370000
2020-02-01,Chiang Rai ,north,0.4863,245632,262505,228021,34484,1873000000,1578330000,294670000
2020-02-01,Chiang Mai ,north,0.5847,559458,696035,530347,165688,7370170000,5130880000,2239290000
2020-02-01,Phichit ,north,0.4729,38839,52701,52330,371,111800000,111220000,580000
2020-02-01,Nakhon Sawan ,north,0.5672,100752,158447,152429,6018,294460000,286030000,8430000
2020-02-01,Tak ,north,0.6523,147648,194219,189857,4362,557850000,541980000,15870000
2020-02-01,Phitsanulok ,north,0.5864,157604,295413,276914,18499,762320000,702620000,59700000
2020-02-01,Phayao ,north,0.5302,23868,56012,53537,2475,103380000,99990000,3390000
2020-02-01,Phetchabun ,north,0.5576,146577,176028,174458,1570,608410000,603990000,4420000
2020-02-01,Phrae ,north,0.5316,27037,63890,56343,7547,139630000,112130000,27500000
2020-02-01,Lampang ,north,0.6043,51479,87287,78082,9205,251550000,205670000,45880000
2020-02-01,Lamphun ,north,0.5384,18849,84386,79719,4667,131490000,122480000,9010000
2020-02-01,Mae Hong Son ,north,0.5352,90999,96207,74330,21877,449480000,278790000,170690000
2020-02-01,Uttaradit ,north,0.4935,48167,91269,90504,765,187160000,185410000,1750000
2020-02-01,Uthai Thani ,north,0.4817,31556,73017,72761,256,120110000,119210000,900000
2020-02-01,Sukhothai ,north,0.5687,66541,113202,75373,37829,269310000,143100000,126210000
2020-02-01,Nan ,north,0.6472,73239,87248,84997,2251,256820000,245990000,10830000
2020-02-01,Kalasin ,east_northeast,0.5371,18427,56357,55963,394,83610000,82700000,910000
2020-02-01,Khon Kaen ,east_northeast,0.483,167450,412000,406262,5738,1329190000,1310100000,19090000
2020-02-01,Chaiyaphum ,east_northeast,0.4028,40467,66801,66384,417,90390000,89290000,1100000
2020-02-01,Nakhon Phanom ,east_northeast,0.6215999999999999,44580,109137,104503,4634,233820000,227460000,6360000
2020-02-01,Nakhon Ratchasima ,east_northeast,0.7008,404857,747501,728203,19298,1932150000,1840470000,91680000
2020-02-01,Buriram ,east_northeast,0.6004999999999999,83002,137005,133846,3159,282460000,277180000,5280000
2020-02-01,Maha Sarakham ,east_northeast,0.46090000000000003,27567,44096,43150,946,70300000,69000000,1300000
2020-02-01,Mukdahan ,east_northeast,0.5681,55621,170496,159435,11061,312910000,286720000,26190000
2020-02-01,Roi Et ,east_northeast,0.49770000000000003,34261,66867,66255,612,90650000,89360000,1290000
2020-02-01,Loei ,east_northeast,0.6151,95837,155403,153612,1791,351670000,344800000,6870000
2020-02-01,Sisaket ,south,0.5938,35864,149774,147936,1838,228870000,223940000,4930000
2020-02-01,Surin ,east_northeast,0.5535,70264,93827,91310,2517,226860000,218080000,8780000
2020-02-01,Nong Khai ,east_northeast,0.608,87202,191258,137915,53343,411500000,333650000,77850000
2020-02-01,Bueng Kan ,east_northeast,0.5028,25036,43501,43335,166,92090000,91670000,420000
2020-02-01,Udon Thani ,east_northeast,0.7967,156229,238576,224242,14334,640720000,570280000,70440000
2020-02-01,Ubon Ratchathani ,east_northeast,0.6304,105265,228071,213551,14520,736140000,666160000,69980000
2020-02-01,Sakon Nakhon ,east_northeast,0.5493,51270,90256,89989,267,187990000,187100000,890000
2020-02-01,Yasothon ,east_northeast,0.5386,13159,45530,44114,1416,59210000,56000000,3210000
2020-02-01,Amnat Charoen ,east_northeast,0.5672999999999999,7510,19126,18394,732,30230000,28570000,1660000
2020-02-01,Nong Bua Lamphu ,east_northeast,0.5027,11792,30423,30309,114,31510000,31340000,170000
2020-03-01,Bangkok,central,0.1843,601577,1184699,816815,367884,14740850000,6403180000,8337670000
2020-03-01,Lopburi ,central,0.1978,14581,78793,78385,408,138970000,138050000,920000
2020-03-01,Phra Nakhon Si Ayutthaya ,central,0.1777,29532,63597,55179,8418,123840000,105720000,18120000
2020-03-01,Saraburi ,central,0.131,16991,39356,38758,598,66300000,65090000,1210000
2020-03-01,Chainat ,central,0.1092,3363,10295,10227,68,13160000,13050000,110000
2020-03-01,Nakhon Pathom ,central,0.1998,32404,77042,76549,493,109100000,108410000,690000
2020-03-01,Sing Buri ,central,0.16899999999999998,4079,13946,13887,59,18930000,18840000,90000
2020-03-01,Ang Thong ,central,0.0863,2025,13506,13463,43,16490000,16440000,50000
2020-03-01,Nonthaburi ,central,0.0788,8526,40214,37510,2704,56280000,48040000,8240000
2020-03-01,Pathum Thani ,central,0.0681,5466,17862,15908,1954,22810000,19560000,3250000
2020-03-01,Samut Prakan ,central,0.12960000000000002,20017,55191,45861,9330,83040000,62860000,20180000
2020-03-01,Samut Sakhon ,central,0.1148,10745,19550,19531,19,31800000,31770000,30000
2020-03-01,Chachoengsao ,east,0.0942,5996,40922,40848,74,46100000,46010000,90000
2020-03-01,Ratchaburi ,central,0.21600000000000003,31770,71160,70692,468,125930000,124990000,940000
2020-03-01,Kanchanaburi ,central,0.1777,144292,286409,275342,11067,906360000,842030000,64330000
2020-03-01,Samut Songkhram ,central,0.21559999999999999,28963,62330,60576,1754,97280000,94000000,3280000
2020-03-01,Suphan Buri ,central,0.32630000000000003,42559,76234,75601,633,157760000,156840000,920000
2020-03-01,Phetchaburi ,central,0.2605,162949,230838,219100,11738,595930000,510200000,85730000
2020-03-01,Prachuap Khiri Khan ,central,0.225,126196,206331,194789,11542,950190000,824340000,125850000
2020-03-01,Chonburi ,east,0.2045,395701,435885,360208,75677,3731030000,1898130000,1832900000
2020-03-01,Chanthaburi ,east,0.22010000000000002,41984,79427,79361,66,227460000,227010000,450000
2020-03-01,Trat ,east,0.25129999999999997,77163,72217,51632,20585,589320000,289690000,299630000
2020-03-01,Nakhon Nayok ,east,0.22699999999999998,71912,127611,127459,152,372080000,371710000,370000
2020-03-01,Prachinburi ,east,0.2463,42395,66725,64843,1882,188940000,183050000,5890000
2020-03-01,Rayong ,east,0.2483,167636,215401,202335,13066,701830000,616260000,85570000
2020-03-01,Sa Kaeo ,east,0.2084,36480,65144,64282,862,193120000,190610000,2510000
2020-03-01,Phuket ,south,0.26530000000000004,354012,390057,294931,95126,7239310000,3374030000,3865280000
2020-03-01,Phatthalung ,south,0.19879999999999998,20396,37646,37577,69,53970000,53780000,190000
2020-03-01,Trang ,south,0.2234,40328,51544,48134,3410,326150000,296170000,29980000
2020-03-01,Ranong ,south,0.16210000000000002,24758,33188,32359,829,100130000,94720000,5410000
2020-03-01,Chumphon ,south,0.21530000000000002,33032,41173,38927,2246,165940000,155210000,10730000
2020-03-01,Pattani ,south,0.2494,9582,12146,12062,84,44620000,44260000,360000
2020-03-01,Yala ,south,0.2407,22779,24289,2358,21931,108710000,9390000,99320000
2020-03-01,Nakhon Si Thammarat ,south,0.20170000000000002,76650,133022,129239,3783,451650000,438990000,12660000
2020-03-01,Narathiwat ,south,0.19879999999999998,20614,27466,11675,15791,94970000,27580000,67390000
2020-03-01,Krabi ,south,0.201,112978,161729,142746,18983,2393230000,1943690000,449540000
2020-03-01,Songkhla ,south,0.1967,110982,204614,150759,53855,1584530000,948130000,636400000
2020-03-01,Phang Nga ,south,0.2231,31591,64015,42625,21390,537310000,235760000,301550000
2020-03-01,Surat Thani ,south,0.2376,119803,133074,89211,43863,1673920000,601160000,1072760000
2020-03-01,Satun ,south,0.20929999999999999,23815,47899,43385,4514,341220000,319930000,21290000
2020-03-01,Kamphaeng Phet ,north,0.1483,19848,31742,31559,183,61070000,60510000,560000
2020-03-01,Chiang Rai ,north,0.22579999999999997,170335,175695,167310,8385,1097220000,1028260000,68960000
2020-03-01,Chiang Mai ,north,0.2432,355162,411040,351724,59316,3505460000,2741710000,763750000
2020-03-01,Phichit ,north,0.1754,17828,22190,22168,22,44340000,44310000,30000
2020-03-01,Nakhon Sawan ,north,0.2076,49958,68791,68496,295,117850000,117460000,390000
2020-03-01,Tak ,north,0.3247,93563,112520,111678,842,302700000,299910000,2790000
2020-03-01,Phitsanulok ,north,0.34119999999999995,112834,140642,137492,3150,323930000,314490000,9440000
2020-03-01,Phayao ,north,0.22829999999999998,15090,24203,24174,29,41340000,41300000,40000
2020-03-01,Phetchabun ,north,0.30579999999999996,104893,121647,121440,207,378890000,378350000,540000
2020-03-01,Phrae ,north,0.1789,15969,24777,23679,1098,45470000,41510000,3960000
2020-03-01,Lampang ,north,0.2853,33368,46181,44585,1596,113330000,105490000,7840000
2020-03-01,Lamphun ,north,0.23600000000000002,12423,36131,35831,300,51790000,51240000,550000
2020-03-01,Mae Hong Son ,north,0.1085,34613,36024,31688,4336,140320000,108540000,31780000
2020-03-01,Uttaradit ,north,0.1183,18557,33424,33342,82,63520000,63340000,180000
2020-03-01,Uthai Thani ,north,0.1649,16303,26916,26864,52,42530000,42350000,180000
2020-03-01,Sukhothai ,north,0.1485,26484,34927,29708,5219,68520000,51850000,16670000
2020-03-01,Nan ,north,0.2302,38213,40195,39804,391,105290000,103470000,1820000
2020-03-01,Kalasin ,east_northeast,0.1107,4112,11147,11134,13,15540000,15520000,20000
2020-03-01,Khon Kaen ,east_northeast,0.17120000000000002,60261,159218,157886,1332,456350000,452060000,4290000
2020-03-01,Chaiyaphum ,east_northeast,0.1206,12328,23996,23447,549,30530000,29420000,1110000
2020-03-01,Nakhon Phanom ,east_northeast,0.16269999999999998,12044,26771,25910,861,52010000,50960000,1050000
2020-03-01,Nakhon Ratchasima ,east_northeast,0.2034,133757,210672,205743,4929,468690000,445910000,22780000
2020-03-01,Buriram ,east_northeast,0.09699999999999999,15274,25658,25370,288,44810000,44420000,390000
2020-03-01,Maha Sarakham ,east_northeast,0.09880000000000001,6528,11152,10968,184,16980000,16740000,240000
2020-03-01,Mukdahan ,east_northeast,0.1475,16479,50071,48153,1918,78640000,74430000,4210000
2020-03-01,Roi Et ,east_northeast,0.1432,8418,16642,16497,145,20910000,20600000,310000
2020-03-01,Loei ,east_northeast,0.08539999999999999,14048,23005,22868,137,45450000,44980000,470000
2020-03-01,Sisaket ,south,0.1552,9395,41154,40968,186,54690000,54220000,470000
2020-03-01,Surin ,east_northeast,0.1384,19765,26589,26196,393,61210000,59990000,1220000
2020-03-01,Nong Khai ,east_northeast,0.1092,16697,33311,26849,6462,67250000,58510000,8740000
2020-03-01,Bueng Kan ,east_northeast,0.1316,7461,13305,13279,26,24850000,24790000,60000
2020-03-01,Udon Thani ,east_northeast,0.1208,25455,40606,37282,3324,106620000,91130000,15490000
2020-03-01,Ubon Ratchathani ,east_northeast,0.1616,30248,66228,63244,2984,180290000,167030000,13260000
2020-03-01,Sakon Nakhon ,east_northeast,0.1344,14135,25648,25622,26,47130000,47060000,70000
2020-03-01,Yasothon ,east_northeast,0.10039999999999999,2712,9698,9682,16,11580000,11550000,30000
2020-03-01,Amnat Charoen ,east_northeast,0.0942,1295,3199,3117,82,4750000,4570000,180000
2020-03-01,Nong Bua Lamphu ,east_northeast,0.059800000000000006,1445,3693,3688,5,3960000,3950000,10000
2020-04-01,Bangkok,central,0.0828,252452,252452,109420,143032,8147070000,434060000,7713010000
2020-04-01,Lopburi ,central,0.0009,40,40,40,0,70000,70000,0
2020-04-01,Phra Nakhon Si Ayutthaya ,central,0.0002,18,18,14,4,70000,20000,50000
2020-04-01,Saraburi ,central,0.0126,416,416,416,0,500000,500000,0
2020-04-01,Chainat ,central,0.0,0,0,0,0,0,0,0
2020-04-01,Nakhon Pathom ,central,0.0134,637,637,637,0,450000,450000,0
2020-04-01,Sing Buri ,central,0.0064,81,81,81,0,70000,70000,0
2020-04-01,Ang Thong ,central,0.0,0,0,0,0,0,0,0
2020-04-01,Nonthaburi ,central,0.0,0,0,0,0,0,0,0
2020-04-01,Pathum Thani ,central,0.0024,163,163,163,0,120000,120000,0
2020-04-01,Samut Prakan ,central,0.0,0,0,0,0,0,0,0
2020-04-01,Samut Sakhon ,central,0.0113,289,289,289,0,410000,410000,0
2020-04-01,Chachoengsao ,east,0.0,0,0,0,0,0,0,0
2020-04-01,Ratchaburi ,central,0.0233,1726,1726,1726,0,2430000,2430000,0
2020-04-01,Kanchanaburi ,central,0.0,0,0,0,0,0,0,0
2020-04-01,Samut Songkhram ,central,0.0001,8,8,0,8,230000,0,230000
2020-04-01,Suphan Buri ,central,0.0,0,0,0,0,0,0,0
2020-04-01,Phetchaburi ,central,0.0,109,109,0,109,3090000,0,3090000
2020-04-01,Prachuap Khiri Khan ,central,0.0,419,419,0,419,11870000,0,11870000
2020-04-01,Chonburi ,east,0.0154,10275,10275,0,10275,573500000,0,573500000
2020-04-01,Chanthaburi ,east,0.0,0,0,0,0,0,0,0
2020-04-01,Trat ,east,0.0025,592,592,0,592,32800000,0,32800000
2020-04-01,Nakhon Nayok ,east,0.0,0,0,0,0,0,0,0
2020-04-01,Prachinburi ,east,0.0002,20,20,0,20,1110000,0,1110000
2020-04-01,Rayong ,east,0.0,0,0,0,0,0,0,0
2020-04-01,Sa Kaeo ,east,0.0,0,0,0,0,0,0,0
2020-04-01,Phuket ,south,0.0034999999999999996,4281,4281,0,4281,277920000,0,277920000
2020-04-01,Phatthalung ,south,0.0024,154,154,154,0,220000,220000,0
2020-04-01,Trang ,south,0.0004,252,252,0,252,16360000,0,16360000
2020-04-01,Ranong ,south,0.0013,316,316,300,16,1310000,270000,1040000
2020-04-01,Chumphon ,south,0.0006,74,74,74,0,170000,170000,0
2020-04-01,Pattani ,south,0.001,35,35,0,35,2270000,0,2270000
2020-04-01,Yala ,south,0.001,56,56,0,56,3640000,0,3640000
2020-04-01,Nakhon Si Thammarat ,south,0.0005,152,152,152,0,220000,220000,0
2020-04-01,Narathiwat ,south,0.0003,25,25,0,25,1620000,0,1620000
2020-04-01,Krabi ,south,0.0009,391,391,0,391,25380000,0,25380000
2020-04-01,Songkhla ,south,0.001,528,528,0,528,39520000,5240000,34280000
2020-04-01,Phang Nga ,south,0.013999999999999999,1479,1479,0,1479,96020000,0,96020000
2020-04-01,Surat Thani ,south,0.02,10741,10741,563,10178,660750000,0,660750000
2020-04-01,Satun ,south,0.001,84,84,0,84,5450000,0,5450000
2020-04-01,Kamphaeng Phet ,north,0.0197,589,589,556,33,1920000,1040000,880000
2020-04-01,Chiang Rai ,north,0.011399999999999999,2113,2113,1311,802,28460000,7160000,21300000
2020-04-01,Chiang Mai ,north,0.0078000000000000005,3523,3523,2707,816,41140000,19460000,21680000
2020-04-01,Phichit ,north,0.0207,17,17,0,17,980000,530000,450000
2020-04-01,Nakhon Sawan ,north,0.032400000000000005,1893,1893,1870,23,3900000,3290000,610000
2020-04-01,Tak ,north,0.0294,2156,2156,2156,0,6750000,6750000,0
2020-04-01,Phitsanulok ,north,0.0212,2084,2084,1981,103,6580000,3840000,2740000
2020-04-01,Phayao ,north,0.0086,10,10,0,10,520000,250000,270000
2020-04-01,Phetchabun ,north,0.0052,6,6,0,6,1800000,1640000,160000
2020-04-01,Phrae ,north,0.0137,328,328,328,0,360000,360000,0
2020-04-01,Lampang ,north,0.047599999999999996,1493,1493,1493,0,3780000,3780000,0
2020-04-01,Lamphun ,north,0.0208,408,408,408,0,340000,340000,0
2020-04-01,Mae Hong Son ,north,0.014199999999999999,1162,1162,974,188,8140000,3150000,4990000
2020-04-01,Uttaradit ,north,0.0248,873,873,856,17,2340000,1890000,450000
2020-04-01,Uthai Thani ,north,0.0026,0,0,0,0,80000,80000,0
2020-04-01,Sukhothai ,north,0.0031,369,369,307,62,2190000,540000,1650000
2020-04-01,Nan ,north,0.0,0,0,0,0,0,0,0
2020-04-01,Kalasin ,east_northeast,0.0012,38,38,38,0,40000,40000,0
2020-04-01,Khon Kaen ,east_northeast,0.0007000000000000001,245,245,245,0,370000,370000,0
2020-04-01,Chaiyaphum ,east_northeast,0.0005,67,67,67,0,30000,30000,0
2020-04-01,Nakhon Phanom ,east_northeast,0.0025,143,143,143,0,120000,120000,0
2020-04-01,Nakhon Ratchasima ,east_northeast,0.0004,280,280,280,0,250000,250000,0
2020-04-01,Buriram ,east_northeast,0.0008,117,117,117,0,60000,60000,0
2020-04-01,Maha Sarakham ,east_northeast,0.0,0,0,0,0,0,0,0
2020-04-01,Mukdahan ,east_northeast,0.0013,114,114,114,0,70000,70000,0
2020-04-01,Roi Et ,east_northeast,0.0004,26,26,0,26,280000,0,280000
2020-04-01,Loei ,east_northeast,0.0,0,0,0,0,0,0,0
2020-04-01,Sisaket ,south,0.0007000000000000001,40,40,40,0,30000,30000,0
2020-04-01,Surin ,east_northeast,0.0,0,0,0,0,0,0,0
2020-04-01,Nong Khai ,east_northeast,0.0002,36,36,36,0,30000,30000,0
2020-04-01,Bueng Kan ,east_northeast,0.0,0,0,0,0,0,0,0
2020-04-01,Udon Thani ,east_northeast,0.0,0,0,0,0,0,0,0
2020-04-01,Ubon Ratchathani ,east_northeast,0.0006,98,98,98,0,120000,120000,0
2020-04-01,Sakon Nakhon ,east_northeast,0.0006,70,70,70,0,50000,50000,0
2020-04-01,Yasothon ,east_northeast,0.0,0,0,0,0,0,0,0
2020-04-01,Amnat Charoen ,east_northeast,0.0008,11,11,11,0,10000,10000,0
2020-04-01,Nong Bua Lamphu ,east_northeast,0.0,0,0,0,0,0,0,0
2020-05-01,Bangkok,central,0.1127,424761,516530,378984,137546,8720920000,1653740000,7067180000
2020-05-01,Lopburi ,central,0.0063,538,538,538,0,800000,800000,0
2020-05-01,Phra Nakhon Si Ayutthaya ,central,0.0161,1269,1269,1269,0,2400000,2400000,0
2020-05-01,Saraburi ,central,0.0229,1053,1053,1053,0,1240000,1240000,0
2020-05-01,Chainat ,central,0.0176,531,531,531,0,660000,660000,0
2020-05-01,Nakhon Pathom ,central,0.031400000000000004,1870,1870,1870,0,2130000,2130000,0
2020-05-01,Sing Buri ,central,0.0417,914,914,914,0,860000,860000,0
2020-05-01,Ang Thong ,central,0.0218,520,520,520,0,540000,540000,0
2020-05-01,Nonthaburi ,central,0.0103,1277,1277,1277,0,1810000,1810000,0
2020-05-01,Pathum Thani ,central,0.0103,976,976,976,0,1160000,1160000,0
2020-05-01,Samut Prakan ,central,0.0,0,0,0,0,0,0,0
2020-05-01,Samut Sakhon ,central,0.0163,939,939,939,0,1390000,1390000,0
2020-05-01,Chachoengsao ,east,0.0068000000000000005,496,496,496,0,640000,640000,0
2020-05-01,Ratchaburi ,central,0.037000000000000005,4086,4086,4086,0,5540000,5540000,0
2020-05-01,Kanchanaburi ,central,0.0557,24727,24727,24727,0,50090000,50090000,0
2020-05-01,Samut Songkhram ,central,0.0273,2212,2212,2212,0,2680000,2680000,0
2020-05-01,Suphan Buri ,central,0.011899999999999999,1157,1157,1157,0,1990000,1990000,0
2020-05-01,Phetchaburi ,central,0.0036,1645,1670,1645,25,4380000,3670000,710000
2020-05-01,Prachuap Khiri Khan ,central,0.006999999999999999,3572,3785,3572,213,17860000,11830000,6030000
2020-05-01,Chonburi ,east,0.0077,14860,18220,8116,10104,601910000,37950000,563960000
2020-05-01,Chanthaburi ,east,0.0,0,0,0,0,0,0,0
2020-05-01,Trat ,east,0.0012,293,293,0,293,16230000,0,16230000
2020-05-01,Nakhon Nayok ,east,0.011000000000000001,2663,2663,2663,0,5310000,5310000,0
2020-05-01,Prachinburi ,east,0.0068000000000000005,1295,1295,1275,20,3640000,3100000,540000
2020-05-01,Rayong ,east,0.0087,4885,4885,4885,0,15300000,15300000,0
2020-05-01,Sa Kaeo ,east,0.0,0,0,0,0,0,0,0
2020-05-01,Phuket ,south,0.0028000000000000004,3621,3941,0,3941,255850000,0,255850000
2020-05-01,Phatthalung ,south,0.0009,119,119,119,0,210000,210000,0
2020-05-01,Trang ,south,0.0007000000000000001,93,94,0,94,3110000,0,3110000
2020-05-01,Ranong ,south,0.0021,231,231,0,231,9010000,0,9010000
2020-05-01,Chumphon ,south,0.0014000000000000002,249,249,249,0,770000,770000,0
2020-05-01,Pattani ,south,0.0069,316,316,316,0,950000,950000,0
2020-05-01,Yala ,south,0.0037,366,387,330,57,2470000,850000,1620000
2020-05-01,Nakhon Si Thammarat ,south,0.0003,101,101,101,0,210000,210000,0
2020-05-01,Narathiwat ,south,0.0013,115,115,115,0,430000,430000,0
2020-05-01,Krabi ,south,0.0004,195,198,0,198,12850000,0,12850000
2020-05-01,Songkhla ,south,0.0009,528,531,0,531,34470000,0,34470000
2020-05-01,Phang Nga ,south,0.009000000000000001,1133,1135,0,1135,73690000,0,73690000
2020-05-01,Surat Thani ,south,0.0178,8239,8239,0,8239,534870000,0,534870000
2020-05-01,Satun ,south,0.0007000000000000001,84,95,0,95,2390000,0,2390000
2020-05-01,Kamphaeng Phet ,north,0.0636,1924,1924,1924,0,3820000,3820000,0
2020-05-01,Chiang Rai ,north,0.0684,10929,10929,10562,367,63680000,53930000,9750000
2020-05-01,Chiang Mai ,north,0.0173,16125,12212,11629,583,98880000,83390000,15490000
2020-05-01,Phichit ,north,0.0489,1867,1867,1867,0,2090000,2090000,0
2020-05-01,Nakhon Sawan ,north,0.1043,6877,6877,6865,12,12540000,12440000,100000
2020-05-01,Tak ,north,0.056100000000000004,5214,5214,5214,0,13920000,13920000,0
2020-05-01,Phitsanulok ,north,0.1035,9502,9502,9410,92,17960000,15680000,2280000
2020-05-01,Phayao ,north,0.0973,2335,2335,2330,5,4000000,3960000,40000
2020-05-01,Phetchabun ,north,0.0858,5739,5739,5739,0,14110000,14110000,0
2020-05-01,Phrae ,north,0.11900000000000001,2968,2968,2968,0,4300000,4300000,0
2020-05-01,Lampang ,north,0.1103,3720,3720,3720,0,9350000,9350000,0
2020-05-01,Lamphun ,north,0.1495,2633,2633,2633,0,3000000,3000000,0
2020-05-01,Mae Hong Son ,north,0.0451,629,629,629,0,2180000,2180000,0
2020-05-01,Uttaradit ,north,0.0654,1988,1988,1979,9,3960000,3890000,70000
2020-05-01,Uthai Thani ,north,0.0583,1117,1117,1117,0,1490000,1490000,0
2020-05-01,Sukhothai ,north,0.0955,4240,4240,4202,38,7380000,6850000,530000
2020-05-01,Nan ,north,0.0155,1569,1569,1569,0,4120000,4120000,0
2020-05-01,Kalasin ,east_northeast,0.0344,1112,1112,1112,0,1720000,1720000,0
2020-05-01,Khon Kaen ,east_northeast,0.0398,9869,9869,9869,0,22850000,22850000,0
2020-05-01,Chaiyaphum ,east_northeast,0.019299999999999998,1948,1948,1948,0,2000000,2000000,0
2020-05-01,Nakhon Phanom ,east_northeast,0.0277,1704,1704,1704,0,2760000,2760000,0
2020-05-01,Nakhon Ratchasima ,east_northeast,0.0121,7709,7709,7709,0,14000000,14000000,0
2020-05-01,Buriram ,east_northeast,0.0084,1331,1331,1331,0,1600000,1600000,0
2020-05-01,Maha Sarakham ,east_northeast,0.0144,1022,1022,1022,0,1770000,1770000,0
2020-05-01,Mukdahan ,east_northeast,0.0126,1172,1172,1172,0,1360000,1360000,0
2020-05-01,Roi Et ,east_northeast,0.016399999999999998,1190,1192,1190,2,1610000,1590000,20000
2020-05-01,Loei ,east_northeast,0.0143,2514,2514,2514,0,3860000,3860000,0
2020-05-01,Sisaket ,south,0.0334,1720,1720,1720,0,1750000,1750000,0
2020-05-01,Surin ,east_northeast,0.0067,871,871,871,0,1400000,1400000,0
2020-05-01,Nong Khai ,east_northeast,0.0264,4234,4234,4234,0,7570000,7570000,0
2020-05-01,Bueng Kan ,east_northeast,0.0233,958,958,958,0,1160000,1160000,0
2020-05-01,Udon Thani ,east_northeast,0.0219,5120,5120,5120,0,10880000,10880000,0
2020-05-01,Ubon Ratchathani ,east_northeast,0.049699999999999994,6945,6945,6945,0,11900000,11900000,0
2020-05-01,Sakon Nakhon ,east_northeast,0.013000000000000001,1643,1643,1643,0,2470000,2470000,0
2020-05-01,Yasothon ,east_northeast,0.029500000000000002,739,739,739,0,1070000,1070000,0
2020-05-01,Amnat Charoen ,east_northeast,0.0493,657,657,657,0,670000,670000,0
2020-05-01,Nong Bua Lamphu ,east_northeast,0.0084,196,196,196,0,170000,170000,0
2020-06-01,Bangkok,central,0.1307,476161,878018,795125,82893,7207940000,5189090000,2018850000
2020-06-01,Lopburi ,central,0.14679999999999999,9170,19370,19370,0,29650000,29650000,0
2020-06-01,Phra Nakhon Si Ayutthaya ,central,0.1103,13005,49438,49268,170,88510000,88220000,290000
2020-06-01,Saraburi ,central,0.1841,14939,30295,30295,0,37050000,37050000,0
2020-06-01,Chainat ,central,0.1261,3565,10667,10667,0,13490000,13490000,0
2020-06-01,Nakhon Pathom ,central,0.16079999999999997,15048,31488,31488,0,38170000,38170000,0
2020-06-01,Sing Buri ,central,0.1067,2282,8146,8146,0,7830000,7830000,0
2020-06-01,Ang Thong ,central,0.0518,1176,3606,3606,0,3860000,3860000,0
2020-06-01,Nonthaburi ,central,0.1182,11994,77935,77935,0,97900000,97900000,0
2020-06-01,Pathum Thani ,central,0.06849999999999999,4852,20678,20678,0,23700000,23700000,0
2020-06-01,Samut Prakan ,central,0.0774,8758,51035,51035,0,64680000,64680000,0
2020-06-01,Samut Sakhon ,central,0.1092,8301,11795,11771,24,17760000,17720000,40000
2020-06-01,Chachoengsao ,east,0.0916,5049,54880,54880,0,74910000,74910000,0
2020-06-01,Ratchaburi ,central,0.17920000000000003,18612,90264,90264,0,124720000,124720000,0
2020-06-01,Kanchanaburi ,central,0.1985,79142,340607,340607,0,722310000,722310000,0
2020-06-01,Samut Songkhram ,central,0.1537,13522,43328,43328,0,55120000,55120000,0
2020-06-01,Suphan Buri ,central,0.1777,19461,55206,55206,0,96210000,96210000,0
2020-06-01,Phetchaburi ,central,0.20629999999999998,85094,205704,205704,0,486740000,486740000,0
2020-06-01,Prachuap Khiri Khan ,central,0.23600000000000002,123905,220118,219957,161,800360000,798310000,2050000
2020-06-01,Chonburi ,east,0.23670000000000002,295090,211505,194406,17099,1291300000,895640000,395660000
2020-06-01,Chanthaburi ,east,0.22699999999999998,38357,58033,58033,0,185420000,185420000,0
2020-06-01,Trat ,east,0.22769999999999999,37762,41158,40843,315,268570000,263400000,5170000
2020-06-01,Nakhon Nayok ,east,0.1537,21178,98644,98644,0,195040000,195040000,0
2020-06-01,Prachinburi ,east,0.0924,10199,29231,29215,16,71780000,71690000,90000
2020-06-01,Rayong ,east,0.207,69574,101527,101527,0,328700000,328700000,0
2020-06-01,Sa Kaeo ,east,0.0897,11454,30635,30635,0,81200000,81200000,0
2020-06-01,Phuket ,south,0.0559,72953,79787,79309,478,836910000,829550000,7360000
2020-06-01,Phatthalung ,south,0.0873,9968,18917,18917,0,33230000,33230000,0
2020-06-01,Trang ,south,0.0351,4399,6886,6886,0,30110000,30110000,0
2020-06-01,Ranong ,south,0.0635,6606,7834,7834,0,41520000,41520000,0
2020-06-01,Chumphon ,south,0.0928,17285,19097,19097,0,89810000,89810000,0
2020-06-01,Pattani ,south,0.1157,5269,5635,5635,0,17020000,17020000,0
2020-06-01,Yala ,south,0.040999999999999995,2873,2999,2999,0,7760000,7760000,0
2020-06-01,Nakhon Si Thammarat ,south,0.1557,59278,96626,96626,0,278370000,278370000,0
2020-06-01,Narathiwat ,south,0.0512,4384,4649,4649,0,17910000,17910000,0
2020-06-01,Krabi ,south,0.0384,20782,27614,27614,0,342820000,342820000,0
2020-06-01,Songkhla ,south,0.1257,69774,84154,84154,0,572000000,572000000,0
2020-06-01,Phang Nga ,south,0.13140000000000002,14736,16639,15591,1048,102580000,65260000,37320000
2020-06-01,Surat Thani ,south,0.018000000000000002,18742,28101,24814,3287,209060000,163500000,45560000
2020-06-01,Satun ,south,0.0821,8553,11785,11785,0,44750000,44750000,0
2020-06-01,Kamphaeng Phet ,north,0.12539999999999998,6170,13289,13165,124,27010000,26860000,150000
2020-06-01,Chiang Rai ,north,0.1978,48372,69652,68637,1015,367560000,363020000,4540000
2020-06-01,Chiang Mai ,north,0.1512,110139,153646,151620,2026,1136410000,1126370000,10040000
2020-06-01,Phichit ,north,0.1784,5413,15184,15184,0,17240000,17240000,0
2020-06-01,Nakhon Sawan ,north,0.20559999999999998,18657,54855,54331,524,100790000,99990000,800000
2020-06-01,Tak ,north,0.14800000000000002,24479,37914,37754,160,101420000,101200000,220000
2020-06-01,Phitsanulok ,north,0.25170000000000003,34987,75841,75578,263,130300000,129670000,630000
2020-06-01,Phayao ,north,0.1478,4564,10785,10481,304,18610000,18170000,440000
2020-06-01,Phetchabun ,north,0.2934,32079,43367,42819,548,107840000,106800000,1040000
2020-06-01,Phrae ,north,0.1548,4764,15552,15552,0,23500000,23500000,0
2020-06-01,Lampang ,north,0.2014,7238,16496,15704,792,42350000,40110000,2240000
2020-06-01,Lamphun ,north,0.1539,3180,19763,18866,897,22920000,21850000,1070000
2020-06-01,Mae Hong Son ,north,0.0658,9123,10849,10214,635,39330000,36610000,2720000
2020-06-01,Uttaradit ,north,0.1957,10164,14356,14356,0,28980000,28980000,0
2020-06-01,Uthai Thani ,north,0.17629999999999998,5119,14232,14232,0,19630000,19630000,0
2020-06-01,Sukhothai ,north,0.18059999999999998,14942,37824,36779,1045,63020000,61310000,1710000
2020-06-01,Nan ,north,0.2762,10617,18489,18423,66,49750000,49640000,110000
2020-06-01,Kalasin ,east_northeast,0.1161,3736,9547,9547,0,15350000,15350000,0
2020-06-01,Khon Kaen ,east_northeast,0.12279999999999999,41215,93020,93020,0,220820000,220820000,0
2020-06-01,Chaiyaphum ,east_northeast,0.09939999999999999,11349,23988,23988,0,25390000,25390000,0
2020-06-01,Nakhon Phanom ,east_northeast,0.084,4922,13180,13180,0,21910000,21910000,0
2020-06-01,Nakhon Ratchasima ,east_northeast,0.1565,120991,222562,222562,0,417380000,417380000,0
2020-06-01,Buriram ,east_northeast,0.0527,8140,17167,17167,0,20510000,20510000,0
2020-06-01,Maha Sarakham ,east_northeast,0.0894,6077,10524,10524,0,19020000,19020000,0
2020-06-01,Mukdahan ,east_northeast,0.053899999999999997,4611,14353,14353,0,17340000,17340000,0
2020-06-01,Roi Et ,east_northeast,0.0806,5764,14020,14020,0,18710000,18710000,0
2020-06-01,Loei ,east_northeast,0.0242,4036,7337,7337,0,11370000,11370000,0
2020-06-01,Sisaket ,south,0.2184,10607,56462,56462,0,58990000,58990000,0
2020-06-01,Surin ,east_northeast,0.1469,19845,28805,28805,0,50240000,50240000,0
2020-06-01,Nong Khai ,east_northeast,0.1054,16009,38143,38143,0,68670000,68670000,0
2020-06-01,Bueng Kan ,east_northeast,0.0781,2978,6849,6849,0,8440000,8440000,0
2020-06-01,Udon Thani ,east_northeast,0.1042,23073,44152,44152,0,96650000,96650000,0
2020-06-01,Ubon Ratchathani ,east_northeast,0.1868,29823,76269,76269,0,133740000,133740000,0
2020-06-01,Sakon Nakhon ,east_northeast,0.0897,10308,38428,38428,0,36140000,36140000,0
2020-06-01,Yasothon ,east_northeast,0.1016,2661,9757,9757,0,14860000,14860000,0
2020-06-01,Amnat Charoen ,east_northeast,0.1027,1129,4098,4098,0,4620000,4620000,0
2020-06-01,Nong Bua Lamphu ,east_northeast,0.0239,570,1287,1287,0,1230000,1230000,0
2020-07-01,Bangkok,central,0.1793,643740,1028230,974554,53676,9749700000,8348660000,1401040000
2020-07-01,Lopburi ,central,0.257,16692,102112,102112,0,120970000,120970000,0
2020-07-01,Phra Nakhon Si Ayutthaya ,central,0.38789999999999997,52072,342259,342138,121,487300000,487120000,180000
2020-07-01,Saraburi ,central,0.3543,36631,113819,113819,0,121740000,121740000,0
2020-07-01,Chainat ,central,0.32159999999999994,9911,25771,25771,0,34430000,34430000,0
2020-07-01,Nakhon Pathom ,central,0.3425,54016,151963,151963,0,187780000,187780000,0
2020-07-01,Sing Buri ,central,0.2274,5357,22053,22053,0,30600000,30600000,0
2020-07-01,Ang Thong ,central,0.1386,3358,22839,22839,0,21490000,21490000,0
2020-07-01,Nonthaburi ,central,0.1957,21787,95810,95652,158,113270000,113090000,180000
2020-07-01,Pathum Thani ,central,0.114,7901,33585,33585,0,36050000,36050000,0
2020-07-01,Samut Prakan ,central,0.1027,10395,62080,62080,0,82660000,82660000,0
2020-07-01,Samut Sakhon ,central,0.1985,16488,38235,38235,0,41370000,41370000,0
2020-07-01,Chachoengsao ,east,0.1821,10458,234565,234565,0,320160000,320160000,0
2020-07-01,Ratchaburi ,central,0.4794,64624,181836,181836,0,299000000,299000000,0
2020-07-01,Kanchanaburi ,central,0.5335,189925,673801,673801,0,1497220000,1497220000,0
2020-07-01,Samut Songkhram ,central,0.461,42803,105053,105053,0,138010000,138010000,0
2020-07-01,Suphan Buri ,central,0.45159999999999995,36348,142273,142273,0,199880000,199880000,0
2020-07-01,Phetchaburi ,central,0.5654,266442,607071,607071,0,1644770000,1644770000,0
2020-07-01,Prachuap Khiri Khan ,central,0.40990000000000004,224481,393239,393124,115,1396620000,1394830000,1790000
2020-07-01,Chonburi ,east,0.2314,371657,460470,447880,12590,2120040000,1956040000,164000000
2020-07-01,Chanthaburi ,east,0.4426,99791,118938,118938,0,369490000,369490000,0
2020-07-01,Trat ,east,0.3953,98169,105270,104929,341,649970000,644440000,5530000
2020-07-01,Nakhon Nayok ,east,0.5004,127667,212347,212347,0,337420000,337420000,0
2020-07-01,Prachinburi ,east,0.4252,56154,86332,86312,20,239180000,239070000,110000
2020-07-01,Rayong ,east,0.2051,91020,151151,151151,0,562690000,562690000,0
2020-07-01,Sa Kaeo ,east,0.42969999999999997,53142,116086,116086,0,345110000,345110000,0
2020-07-01,Phuket ,south,0.0513,57992,76186,75845,341,790120000,784030000,6090000
2020-07-01,Phatthalung ,south,0.36479999999999996,39826,66918,66918,0,168640000,168640000,0
2020-07-01,Trang ,south,0.2535,34768,40841,40841,0,225690000,225690000,0
2020-07-01,Ranong ,south,0.1863,21337,25423,25423,0,117440000,117440000,0
2020-07-01,Chumphon ,south,0.3032,60372,78926,78926,0,321990000,321990000,0
2020-07-01,Pattani ,south,0.1257,5164,5723,5723,0,22520000,22520000,0
2020-07-01,Yala ,south,0.1043,11132,11438,11438,0,39640000,39640000,0
2020-07-01,Nakhon Si Thammarat ,south,0.4765,153194,225755,225755,0,599300000,599300000,0
2020-07-01,Narathiwat ,south,0.0932,8946,9596,9596,0,37330000,37330000,0
2020-07-01,Krabi ,south,0.0637,33488,45045,44913,132,610810000,608930000,1880000
2020-07-01,Songkhla ,south,0.3046,183480,344347,344180,167,2228440000,2226720000,1720000
2020-07-01,Phang Nga ,south,0.0849,13829,34564,33731,833,126280000,114910000,11370000
2020-07-01,Surat Thani ,south,0.1142,90399,112039,104122,7917,752020000,607430000,144590000
2020-07-01,Satun ,south,0.2815,31014,51034,50929,105,159860000,159540000,320000
2020-07-01,Kamphaeng Phet ,north,0.3483,18865,33627,33510,117,54540000,54420000,120000
2020-07-01,Chiang Rai ,north,0.40509999999999996,134159,147357,146320,1037,870570000,865520000,5050000
2020-07-01,Chiang Mai ,north,0.4436,357496,403825,401316,2509,2974900000,2958860000,16040000
2020-07-01,Phichit ,north,0.3506,17954,45379,45379,0,53080000,53080000,0
2020-07-01,Nakhon Sawan ,north,0.3728,42279,71230,70848,382,124620000,124020000,600000
2020-07-01,Tak ,north,0.4263,68984,92466,92322,144,264470000,264240000,230000
2020-07-01,Phitsanulok ,north,0.428,78966,147484,147263,221,292270000,291780000,490000
2020-07-01,Phayao ,north,0.3486,12058,33789,33504,285,68780000,68410000,370000
2020-07-01,Phetchabun ,north,0.45280000000000004,86319,106008,105382,626,251700000,249810000,1890000
2020-07-01,Phrae ,north,0.4263,15832,40449,40449,0,65900000,65900000,0
2020-07-01,Lampang ,north,0.40380000000000005,23547,60658,59721,937,163210000,160060000,3150000
2020-07-01,Lamphun ,north,0.38539999999999996,10685,60836,60169,667,58670000,58000000,670000
2020-07-01,Mae Hong Son ,north,0.18230000000000002,23166,23893,23295,598,80360000,77340000,3020000
2020-07-01,Uttaradit ,north,0.321,25148,53805,53805,0,98910000,98910000,0
2020-07-01,Uthai Thani ,north,0.40850000000000003,17973,37828,37828,0,58240000,58240000,0
2020-07-01,Sukhothai ,north,0.40619999999999995,42207,56388,55281,1107,99200000,96530000,2670000
2020-07-01,Nan ,north,0.5078,28852,41341,41288,53,86870000,86740000,130000
2020-07-01,Kalasin ,east_northeast,0.2289,8702,39629,39629,0,47790000,47790000,0
2020-07-01,Khon Kaen ,east_northeast,0.35960000000000003,123572,214340,214340,0,670260000,670260000,0
2020-07-01,Chaiyaphum ,east_northeast,0.26170000000000004,37967,95381,95381,0,77990000,77990000,0
2020-07-01,Nakhon Phanom ,east_northeast,0.355,22314,52162,52162,0,83110000,83110000,0
2020-07-01,Nakhon Ratchasima ,east_northeast,0.42219999999999996,299236,533779,533779,0,1259370000,1259370000,0
2020-07-01,Buriram ,east_northeast,0.2844,44028,70976,70976,0,110660000,110660000,0
2020-07-01,Maha Sarakham ,east_northeast,0.32409999999999994,25394,42096,42096,0,42910000,42910000,0
2020-07-01,Mukdahan ,east_northeast,0.1245,9603,35603,35603,0,56120000,56120000,0
2020-07-01,Roi Et ,east_northeast,0.3307,26049,47257,47257,0,68370000,68370000,0
2020-07-01,Loei ,east_northeast,0.3103,47648,95378,95372,6,163630000,163600000,30000
2020-07-01,Sisaket ,south,0.3356,18680,69681,69681,0,68030000,68030000,0
2020-07-01,Surin ,east_northeast,0.2725,42214,55286,55286,0,92270000,92270000,0
2020-07-01,Nong Khai ,east_northeast,0.3429,53929,85296,85296,0,184920000,184920000,0
2020-07-01,Bueng Kan ,east_northeast,0.3465,15582,25969,25969,0,40720000,40720000,0
2020-07-01,Udon Thani ,east_northeast,0.4203,102440,193043,193043,0,503690000,503690000,0
2020-07-01,Ubon Ratchathani ,east_northeast,0.3182,57259,98066,98066,0,200110000,200110000,0
2020-07-01,Sakon Nakhon ,east_northeast,0.1993,18759,39995,39995,0,41470000,41470000,0
2020-07-01,Yasothon ,east_northeast,0.248,7748,24375,24375,0,21370000,21370000,0
2020-07-01,Amnat Charoen ,east_northeast,0.2278,3394,9355,9355,0,8540000,8540000,0
2020-07-01,Nong Bua Lamphu ,east_northeast,0.2511,6194,13453,13453,0,12840000,12840000,0
2020-08-01,Bangkok,central,0.20629999999999998,780196,1799201,1749507,49694,15276510000,14263350000,1013160000
2020-08-01,Lopburi ,central,0.2978,21302,151468,151468,0,163290000,163290000,0
2020-08-01,Phra Nakhon Si Ayutthaya ,central,0.41859999999999997,57745,397232,397058,174,509040000,508780000,260000
2020-08-01,Saraburi ,central,0.3753,42396,137302,137302,0,132170000,132170000,0
2020-08-01,Chainat ,central,0.3468,10732,33572,33572,0,40370000,40370000,0
2020-08-01,Nakhon Pathom ,central,0.3682,56197,171185,171185,0,190380000,190380000,0
2020-08-01,Sing Buri ,central,0.23399999999999999,5862,22555,22555,0,28170000,28170000,0
2020-08-01,Ang Thong ,central,0.1689,4140,23777,23777,0,21250000,21250000,0
2020-08-01,Nonthaburi ,central,0.26839999999999997,31227,130004,129875,129,138350000,138200000,150000
2020-08-01,Pathum Thani ,central,0.1827,12316,47798,47798,0,46180000,46180000,0
2020-08-01,Samut Prakan ,central,0.1613,20160,73284,73284,0,87820000,87820000,0
2020-08-01,Samut Sakhon ,central,0.2169,18173,42363,42363,0,41250000,41250000,0
2020-08-01,Chachoengsao ,east,0.2119,14665,232378,232378,0,285460000,285460000,0
2020-08-01,Ratchaburi ,central,0.4416,60292,164461,164461,0,243390000,243390000,0
2020-08-01,Kanchanaburi ,central,0.5085000000000001,181482,639974,639769,205,1280980000,1279440000,1540000
2020-08-01,Samut Songkhram ,central,0.4646,43662,106969,106969,0,126470000,126470000,0
2020-08-01,Suphan Buri ,central,0.4388,36057,122193,122193,0,154500000,154500000,0
2020-08-01,Phetchaburi ,central,0.5232,246334,563634,563440,194,1376170000,1373900000,2270000
2020-08-01,Prachuap Khiri Khan ,central,0.37689999999999996,215954,430193,429965,228,1376630000,1372990000,3640000
2020-08-01,Chonburi ,east,0.2919,418485,574334,563924,10410,2365110000,2216560000,148550000
2020-08-01,Chanthaburi ,east,0.33659999999999995,73812,91373,91373,0,255470000,255470000,0
2020-08-01,Trat ,east,0.32880000000000004,94544,101393,101242,151,593080000,590710000,2370000
2020-08-01,Nakhon Nayok ,east,0.5075,136131,226425,226425,0,323810000,323810000,0
2020-08-01,Prachinburi ,east,0.3897,51381,78993,78973,20,196980000,196870000,110000
2020-08-01,Rayong ,east,0.2601,105226,208281,208281,0,697830000,697830000,0
2020-08-01,Sa Kaeo ,east,0.3123,44696,98646,98646,0,263940000,263940000,0
2020-08-01,Phuket ,south,0.073,82086,104820,104275,545,979570000,970130000,9440000
2020-08-01,Phatthalung ,south,0.38539999999999996,40446,66219,66219,0,150190000,150190000,0
2020-08-01,Trang ,south,0.2416,32809,38227,38227,0,190120000,190120000,0
2020-08-01,Ranong ,south,0.1685,20900,24734,24734,0,102830000,102830000,0
2020-08-01,Chumphon ,south,0.273,56495,71639,71639,0,263040000,263040000,0
2020-08-01,Pattani ,south,0.1745,7539,8944,8944,0,31680000,31680000,0
2020-08-01,Yala ,south,0.1863,20592,13742,13742,0,42860000,42860000,0
2020-08-01,Nakhon Si Thammarat ,south,0.38189999999999996,144645,212456,212456,0,507600000,507600000,0
2020-08-01,Narathiwat ,south,0.1058,9538,9929,9929,0,34760000,34760000,0
2020-08-01,Krabi ,south,0.0825,41409,53591,53493,98,653860000,652730000,1130000
2020-08-01,Songkhla ,south,0.2817,136133,287446,287163,283,1673600000,1672060000,1540000
2020-08-01,Phang Nga ,south,0.09570000000000001,15316,38890,38396,494,132290000,124260000,8030000
2020-08-01,Surat Thani ,south,0.1281,100977,123833,115899,7934,781780000,642330000,139450000
2020-08-01,Satun ,south,0.2933,29765,52016,51924,92,146730000,146390000,340000
2020-08-01,Kamphaeng Phet ,north,0.3247,17685,30994,30898,96,45260000,45160000,100000
2020-08-01,Chiang Rai ,north,0.3912,132684,143607,142504,1103,766350000,758650000,7700000
2020-08-01,Chiang Mai ,north,0.4158,332872,375966,373329,2637,2495440000,2477260000,18180000
2020-08-01,Phichit ,north,0.3743,19652,43919,43919,0,48800000,48800000,0
2020-08-01,Nakhon Sawan ,north,0.40759999999999996,46594,68528,68216,312,113910000,113440000,470000
2020-08-01,Tak ,north,0.4321,70210,85989,85857,132,233680000,233450000,230000
2020-08-01,Phitsanulok ,north,0.4435,83970,139576,139408,168,262790000,262410000,380000
2020-08-01,Phayao ,north,0.37479999999999997,13629,33714,33518,196,65270000,65020000,250000
2020-08-01,Phetchabun ,north,0.40020000000000006,80240,96640,96132,508,218080000,216490000,1590000
2020-08-01,Phrae ,north,0.39759999999999995,14996,35156,35156,0,54410000,54410000,0
2020-08-01,Lampang ,north,0.4164,24814,59530,58758,772,151610000,149610000,2000000
2020-08-01,Lamphun ,north,0.39840000000000003,11241,54722,54189,533,50130000,49620000,510000
2020-08-01,Mae Hong Son ,north,0.22030000000000002,24348,25010,24342,668,80150000,76780000,3370000
2020-08-01,Uttaradit ,north,0.30670000000000003,23979,49910,49910,0,82570000,82570000,0
2020-08-01,Uthai Thani ,north,0.3851,16988,34667,34667,0,48040000,48040000,0
2020-08-01,Sukhothai ,north,0.3704,37027,48211,47298,913,76580000,74330000,2250000
2020-08-01,Nan ,north,0.4653,26918,37414,37341,73,70780000,70600000,180000
2020-08-01,Kalasin ,east_northeast,0.2492,8932,40650,40650,0,44120000,44120000,0
2020-08-01,Khon Kaen ,east_northeast,0.3942,138790,241433,241357,76,679550000,679270000,280000
2020-08-01,Chaiyaphum ,east_northeast,0.278,30318,77766,77766,0,57230000,57230000,0
2020-08-01,Nakhon Phanom ,east_northeast,0.40049999999999997,26147,63369,63275,94,91030000,90730000,300000
2020-08-01,Nakhon Ratchasima ,east_northeast,0.4612,317162,567554,565721,1833,1210220000,1201260000,8960000
2020-08-01,Buriram ,east_northeast,0.336,51947,84198,84125,73,118190000,118040000,150000
2020-08-01,Maha Sarakham ,east_northeast,0.34729999999999994,28403,47184,47184,0,43290000,43290000,0
2020-08-01,Mukdahan ,east_northeast,0.19149999999999998,14839,55015,55015,0,78050000,78050000,0
2020-08-01,Roi Et ,east_northeast,0.37439999999999996,33945,61782,61782,0,80450000,80450000,0
2020-08-01,Loei ,east_northeast,0.3317,56511,113133,113073,60,174730000,174570000,160000
2020-08-01,Sisaket ,south,0.35950000000000004,19660,70126,70126,0,61620000,61620000,0
2020-08-01,Surin ,east_northeast,0.3136,50347,65951,65905,46,99110000,98990000,120000
2020-08-01,Nong Khai ,east_northeast,0.4169,66447,104557,104431,126,204180000,203760000,420000
2020-08-01,Bueng Kan ,east_northeast,0.3785,16192,26984,26978,6,38090000,38070000,20000
2020-08-01,Udon Thani ,east_northeast,0.4941,122858,232566,232397,169,546300000,545740000,560000
2020-08-01,Ubon Ratchathani ,east_northeast,0.35960000000000003,62374,105301,105260,41,193470000,193310000,160000
2020-08-01,Sakon Nakhon ,east_northeast,0.4191,39016,85476,85406,70,79820000,79700000,120000
2020-08-01,Yasothon ,east_northeast,0.267,8813,28076,28076,0,22150000,22150000,0
2020-08-01,Amnat Charoen ,east_northeast,0.253,3835,10571,10571,0,8690000,8690000,0
2020-08-01,Nong Bua Lamphu ,east_northeast,0.2261,6190,13445,13440,5,11550000,11540000,10000
2020-09-01,Bangkok,central,0.204,764077,1782451,1728642,53809,15065480000,14106670000,958810000
2020-09-01,Lopburi ,central,0.31579999999999997,22268,159479,159385,94,172610000,172490000,120000
2020-09-01,Phra Nakhon Si Ayutthaya ,central,0.4337,60011,405725,405311,414,523630000,522760000,870000
2020-09-01,Saraburi ,central,0.3945,43543,145325,145325,0,144920000,144920000,0
2020-09-01,Chainat ,central,0.36329999999999996,12546,38038,38038,0,45830000,45830000,0
2020-09-01,Nakhon Pathom ,central,0.38939999999999997,59495,182255,182105,150,219310000,219070000,240000
2020-09-01,Sing Buri ,central,0.26739999999999997,6051,21157,21157,0,27230000,27230000,0
2020-09-01,Ang Thong ,central,0.1923,4777,29486,29486,0,29170000,29170000,0
2020-09-01,Nonthaburi ,central,0.28809999999999997,35600,121052,121052,0,128870000,128870000,0
2020-09-01,Pathum Thani ,central,0.2182,14656,49557,49557,0,49950000,49950000,0
2020-09-01,Samut Prakan ,central,0.18539999999999998,22593,85852,85852,0,109140000,109140000,0
2020-09-01,Samut Sakhon ,central,0.23420000000000002,19697,45997,45916,81,46770000,46680000,90000
2020-09-01,Chachoengsao ,east,0.24719999999999998,17957,239974,239966,8,320760000,320750000,10000
2020-09-01,Ratchaburi ,central,0.44549999999999995,56962,158522,158522,0,234970000,234970000,0
2020-09-01,Kanchanaburi ,central,0.519,188828,686014,685821,193,1386650000,1385420000,1230000
2020-09-01,Samut Songkhram ,central,0.4685,43315,107171,107171,0,127170000,127170000,0
2020-09-01,Suphan Buri ,central,0.4573,36606,123743,122385,1358,157710000,154470000,3240000
2020-09-01,Phetchaburi ,central,0.531,250890,534233,533799,434,1289060000,1283980000,5080000
2020-09-01,Prachuap Khiri Khan ,central,0.3799,204470,369834,369585,249,1169100000,1165130000,3970000
2020-09-01,Chonburi ,east,0.2907,393027,576005,565294,10711,2360710000,2248620000,112090000
2020-09-01,Chanthaburi ,east,0.35719999999999996,76157,94781,94781,0,261740000,261740000,0
2020-09-01,Trat ,east,0.3135,83921,90328,90161,167,531450000,529110000,2340000
2020-09-01,Nakhon Nayok ,east,0.4928,135272,227497,227497,0,395190000,395190000,0
2020-09-01,Prachinburi ,east,0.40850000000000003,53087,81627,81627,0,227680000,227680000,0
2020-09-01,Rayong ,east,0.2863,109834,216172,216172,0,787220000,787220000,0
2020-09-01,Sa Kaeo ,east,0.303,40770,89981,89981,0,265140000,265140000,0
2020-09-01,Phuket ,south,0.10859999999999999,129927,162323,161848,475,1551700000,1541200000,10500000
2020-09-01,Phatthalung ,south,0.41479999999999995,42766,69178,69178,0,187320000,187320000,0
2020-09-01,Trang ,south,0.2631,35970,42573,42573,0,243620000,243620000,0
2020-09-01,Ranong ,south,0.1563,19360,25234,25234,0,96030000,96030000,0
2020-09-01,Chumphon ,south,0.2521,44841,61950,61950,0,229240000,229240000,0
2020-09-01,Pattani ,south,0.1967,8362,9424,9424,0,39870000,39870000,0
2020-09-01,Yala ,south,0.17579999999999998,15161,15621,15621,0,55420000,55420000,0
2020-09-01,Nakhon Si Thammarat ,south,0.5851,202468,299277,299277,0,1057640000,1057640000,0
2020-09-01,Narathiwat ,south,0.11289999999999999,11087,12024,12024,0,48790000,48790000,0
2020-09-01,Krabi ,south,0.07719999999999999,36347,48796,47814,982,556550000,544150000,12400000
2020-09-01,Songkhla ,south,0.2721,142006,300387,300162,225,1939360000,1937760000,1600000
2020-09-01,Phang Nga ,south,0.1234,19873,51065,50809,256,182130000,179640000,2490000
2020-09-01,Surat Thani ,south,0.1343,106453,130573,124749,5824,755050000,699470000,55580000
2020-09-01,Satun ,south,0.3038,35403,60503,60431,72,182380000,182190000,190000
2020-09-01,Kamphaeng Phet ,north,0.3452,19259,33783,33666,117,51840000,51720000,120000
2020-09-01,Chiang Rai ,north,0.4169,139458,151398,150494,904,977720000,971710000,6010000
2020-09-01,Chiang Mai ,north,0.4003,300060,331013,326939,4074,2456250000,2427370000,28880000
2020-09-01,Phichit ,north,0.39280000000000004,21069,48874,48874,0,62910000,62910000,0
2020-09-01,Nakhon Sawan ,north,0.41369999999999996,48624,71803,71550,253,128300000,127920000,380000
2020-09-01,Tak ,north,0.41859999999999997,67824,82755,82645,110,248870000,248690000,180000
2020-09-01,Phitsanulok ,north,0.4857,92613,150674,150418,256,302880000,302290000,590000
2020-09-01,Phayao ,north,0.3604,13025,33368,33154,214,70570000,70310000,260000
2020-09-01,Phetchabun ,north,0.42700000000000005,82940,99104,98654,450,228180000,226850000,1330000
2020-09-01,Phrae ,north,0.42229999999999995,16527,38684,38684,0,65220000,65220000,0
2020-09-01,Lampang ,north,0.4625,28987,67378,66585,793,185830000,183870000,1960000
2020-09-01,Lamphun ,north,0.42560000000000003,12436,57450,56998,452,57660000,57230000,430000
2020-09-01,Mae Hong Son ,north,0.22039999999999998,25267,25945,25225,720,100050000,96270000,3780000
2020-09-01,Uttaradit ,north,0.32799999999999996,24825,50455,50455,0,96870000,96870000,0
2020-09-01,Uthai Thani ,north,0.3947,18280,37596,37596,0,57770000,57770000,0
2020-09-01,Sukhothai ,north,0.4028,39580,50578,50439,139,91500000,91150000,350000
2020-09-01,Nan ,north,0.4732,28416,39353,39330,23,80150000,80070000,80000
2020-09-01,Kalasin ,east_northeast,0.26789999999999997,9798,42973,42973,0,51660000,51660000,0
2020-09-01,Khon Kaen ,east_northeast,0.4105,140327,244083,244002,81,758120000,757800000,320000
2020-09-01,Chaiyaphum ,east_northeast,0.28850000000000003,35629,89038,89038,0,71160000,71160000,0
2020-09-01,Nakhon Phanom ,east_northeast,0.4157,25827,62954,62889,65,100310000,100100000,210000
2020-09-01,Nakhon Ratchasima ,east_northeast,0.4746,320656,561001,559625,1376,1202340000,1195900000,6440000
2020-09-01,Buriram ,east_northeast,0.3557,52691,85382,85339,43,133720000,133610000,110000
2020-09-01,Maha Sarakham ,east_northeast,0.35200000000000004,26442,43933,43933,0,47410000,47410000,0
2020-09-01,Mukdahan ,east_northeast,0.2054,15281,56654,56654,0,89500000,89500000,0
2020-09-01,Roi Et ,east_northeast,0.3759,31188,56781,56781,0,77260000,77260000,0
2020-09-01,Loei ,east_northeast,0.3447,55228,112537,112474,63,168270000,168090000,180000
2020-09-01,Sisaket ,south,0.37549999999999994,20868,77843,77843,0,75380000,75380000,0
2020-09-01,Surin ,east_northeast,0.33130000000000004,51598,67589,67551,38,100050000,99960000,90000
2020-09-01,Nong Khai ,east_northeast,0.4178,63730,100287,100168,119,193690000,193330000,360000
2020-09-01,Bueng Kan ,east_northeast,0.3914,17150,28886,28872,14,43300000,43270000,30000
2020-09-01,Udon Thani ,east_northeast,0.49329999999999996,118046,223489,223354,135,606490000,606040000,450000
2020-09-01,Ubon Ratchathani ,east_northeast,0.35369999999999996,67410,115500,115426,74,204150000,204000000,150000
2020-09-01,Sakon Nakhon ,east_northeast,0.4302,40289,87148,87064,84,141900000,141780000,120000
2020-09-01,Yasothon ,east_northeast,0.289,10286,32711,32711,0,28480000,28480000,0
2020-09-01,Amnat Charoen ,east_northeast,0.2626,4239,11684,11684,0,10960000,10960000,0
2020-09-01,Nong Bua Lamphu ,east_northeast,0.2651,6814,14281,14246,35,12330000,12270000,60000
2020-10-01,Bangkok,central,0.2229,868200,1939659,1883019,56640,11036480000,9467420000,1569060000
2020-10-01,Lopburi ,central,0.3448,34146,192993,192907,86,257140000,257040000,100000
2020-10-01,Phra Nakhon Si Ayutthaya ,central,0.4092,60647,385896,385459,437,701980000,700640000,1340000
2020-10-01,Saraburi ,central,0.3857,62916,263164,263044,120,392230000,392090000,140000
2020-10-01,Chainat ,central,0.3306,11344,44297,44297,0,61130000,61130000,0
2020-10-01,Nakhon Pathom ,central,0.3782,62866,185483,185228,255,263810000,263050000,760000
2020-10-01,Sing Buri ,central,0.29359999999999997,6761,28431,28431,0,49070000,49070000,0
2020-10-01,Ang Thong ,central,0.18100000000000002,3874,33934,33934,0,36240000,36240000,0
2020-10-01,Nonthaburi ,central,0.27449999999999997,34665,106566,106513,53,141210000,141150000,60000
2020-10-01,Pathum Thani ,central,0.2043,20856,85682,85682,0,125820000,125820000,0
2020-10-01,Samut Prakan ,central,0.1802,26620,81890,81749,141,136440000,136270000,170000
2020-10-01,Samut Sakhon ,central,0.22440000000000002,20706,50837,50740,97,76600000,76500000,100000
2020-10-01,Chachoengsao ,east,0.2894,21697,279170,279159,11,399940000,399930000,10000
2020-10-01,Ratchaburi ,central,0.4056,57487,103670,103581,89,161700000,161420000,280000
2020-10-01,Kanchanaburi ,central,0.5675,220388,673220,673069,151,1496380000,1495470000,910000
2020-10-01,Samut Songkhram ,central,0.4829,64922,165485,165173,312,178620000,178110000,510000
2020-10-01,Suphan Buri ,central,0.5038,58518,215680,215417,263,259610000,259140000,470000
2020-10-01,Phetchaburi ,central,0.5277000000000001,285324,595218,594664,554,1815930000,1811480000,4450000
2020-10-01,Prachuap Khiri Khan ,central,0.4667,338238,504715,504646,69,2156420000,2155620000,800000
2020-10-01,Chonburi ,east,0.2655,418197,646957,636378,10579,3575320000,3378320000,197000000
2020-10-01,Chanthaburi ,east,0.42219999999999996,104747,139299,139258,41,411550000,411370000,180000
2020-10-01,Trat ,east,0.3097,74756,88474,88304,170,564730000,562070000,2660000
2020-10-01,Nakhon Nayok ,east,0.45030000000000003,95363,182690,182243,447,347660000,345830000,1830000
2020-10-01,Prachinburi ,east,0.369,56283,100922,100879,43,266120000,265900000,220000
2020-10-01,Rayong ,east,0.3274,158258,300284,300229,55,1378630000,1378160000,470000
2020-10-01,Sa Kaeo ,east,0.24559999999999998,28817,76507,76507,0,233990000,233990000,0
2020-10-01,Phuket ,south,0.1103,156175,192248,191358,890,1644830000,1615690000,29140000
2020-10-01,Phatthalung ,south,0.42590000000000006,51359,94535,94535,0,153800000,153800000,0
2020-10-01,Trang ,south,0.30820000000000003,44720,58211,58211,0,250860000,250860000,0
2020-10-01,Ranong ,south,0.1759,19794,26211,26211,0,75140000,75140000,0
2020-10-01,Chumphon ,south,0.2445,45888,60438,60438,0,255500000,255500000,0
2020-10-01,Pattani ,south,0.2069,8356,10431,10431,0,32690000,32690000,0
2020-10-01,Yala ,south,0.5322,61588,79382,79382,0,215430000,215430000,0
2020-10-01,Nakhon Si Thammarat ,south,0.5702,197936,285607,285473,134,1114540000,1113800000,740000
2020-10-01,Narathiwat ,south,0.1247,11558,12772,12772,0,39650000,39650000,0
2020-10-01,Krabi ,south,0.0953,53893,74263,73288,975,938310000,924080000,14230000
2020-10-01,Songkhla ,south,0.2532,161620,254528,254216,312,1563870000,1561560000,2310000
2020-10-01,Phang Nga ,south,0.14529999999999998,28154,76357,75545,812,275230000,266980000,8250000
2020-10-01,Surat Thani ,south,0.14859999999999998,104318,144085,140210,3875,850490000,803310000,47180000
2020-10-01,Satun ,south,0.32380000000000003,45849,76765,76676,89,339100000,338700000,400000
2020-10-01,Kamphaeng Phet ,north,0.38189999999999996,30295,57652,57482,170,110240000,109970000,270000
2020-10-01,Chiang Rai ,north,0.4561,169909,219254,218035,1219,1571660000,1562540000,9120000
2020-10-01,Chiang Mai ,north,0.5396,469898,686287,681314,4973,4898800000,4866560000,32240000
2020-10-01,Phichit ,north,0.41840000000000005,24127,51451,51451,0,89290000,89290000,0
2020-10-01,Nakhon Sawan ,north,0.4359,55167,101315,101115,200,225840000,225140000,700000
2020-10-01,Tak ,north,0.4927,100253,128063,127924,139,401890000,401270000,620000
2020-10-01,Phitsanulok ,north,0.5075999999999999,106841,184132,183777,355,500260000,499270000,990000
2020-10-01,Phayao ,north,0.4193,21257,43871,43622,249,97870000,97400000,470000
2020-10-01,Phetchabun ,north,0.4706,139542,154372,153708,664,443210000,441460000,1750000
2020-10-01,Phrae ,north,0.4671,20972,50003,50003,0,95040000,95040000,0
2020-10-01,Lampang ,north,0.5249,41343,107825,106715,1110,315580000,310620000,4960000
2020-10-01,Lamphun ,north,0.47090000000000004,16728,81424,80886,538,109840000,109080000,760000
2020-10-01,Mae Hong Son ,north,0.3373,67684,69890,69153,737,276950000,273140000,3810000
2020-10-01,Uttaradit ,north,0.3956,44047,63381,63381,0,105380000,105380000,0
2020-10-01,Uthai Thani ,north,0.4182,19683,52004,52004,0,88660000,88660000,0
2020-10-01,Sukhothai ,north,0.5674,66869,98164,97042,1122,298500000,295710000,2790000
2020-10-01,Nan ,north,0.5626,64910,79238,79137,101,165800000,165220000,580000
2020-10-01,Kalasin ,east_northeast,0.3181,13205,36885,36885,0,51080000,51080000,0
2020-10-01,Khon Kaen ,east_northeast,0.47700000000000004,147641,312470,312411,59,914170000,913940000,230000
2020-10-01,Chaiyaphum ,east_northeast,0.3478,42963,79812,79812,0,108710000,108710000,0
2020-10-01,Nakhon Phanom ,east_northeast,0.4792,32744,84972,84878,94,123890000,123600000,290000
2020-10-01,Nakhon Ratchasima ,east_northeast,0.5033,362428,594196,592567,1629,1183960000,1177540000,6420000
2020-10-01,Buriram ,east_northeast,0.377,53310,102808,102761,47,214800000,214340000,460000
2020-10-01,Maha Sarakham ,east_northeast,0.3898,29691,57995,57995,0,79380000,79380000,0
2020-10-01,Mukdahan ,east_northeast,0.2767,21890,82545,82545,0,117390000,117390000,0
2020-10-01,Roi Et ,east_northeast,0.3926,31714,82471,82471,0,108980000,108980000,0
2020-10-01,Loei ,east_northeast,0.5746,109372,203160,203075,85,328440000,328140000,300000
2020-10-01,Sisaket ,south,0.38789999999999997,22611,62950,62950,0,81670000,81670000,0
2020-10-01,Surin ,east_northeast,0.3607,58463,76985,76937,48,160610000,160510000,100000
2020-10-01,Nong Khai ,east_northeast,0.44049999999999995,65524,155279,155152,127,253800000,253430000,370000
2020-10-01,Bueng Kan ,east_northeast,0.4474,22991,42801,42775,26,59260000,59220000,40000
2020-10-01,Udon Thani ,east_northeast,0.5305,130080,295718,295516,202,725820000,725180000,640000
2020-10-01,Ubon Ratchathani ,east_northeast,0.4,84707,164754,164682,72,250500000,250340000,160000
2020-10-01,Sakon Nakhon ,east_northeast,0.5193,65331,154571,154469,102,216880000,216690000,190000
2020-10-01,Yasothon ,east_northeast,0.3129,10449,32081,32081,0,32200000,32200000,0
2020-10-01,Amnat Charoen ,east_northeast,0.3056,4958,21185,21185,0,30260000,30260000,0
2020-10-01,Nong Bua Lamphu ,east_northeast,0.295,7717,22657,22632,25,19340000,19310000,30000
2020-11-01,Bangkok,central,0.2557,1047121,2364196,2291268,72928,14009630000,11988410000,2021220000
2020-11-01,Lopburi ,central,0.42469999999999997,44863,249880,249716,164,336170000,335930000,240000
2020-11-01,Phra Nakhon Si Ayutthaya ,central,0.4738,70456,430542,430007,535,794390000,792740000,1650000
2020-11-01,Saraburi ,central,0.4362,77077,330576,330291,285,493680000,493250000,430000
2020-11-01,Chainat ,central,0.3987,15316,54630,54630,0,77010000,77010000,0
2020-11-01,Nakhon Pathom ,central,0.4227,69677,205444,205079,365,292700000,291610000,1090000
2020-11-01,Sing Buri ,central,0.3272,8942,35046,35046,0,61050000,61050000,0
2020-11-01,Ang Thong ,central,0.1931,4972,35703,35703,0,36630000,36630000,0
2020-11-01,Nonthaburi ,central,0.40759999999999996,59852,157491,156893,598,218590000,217670000,920000
2020-11-01,Pathum Thani ,central,0.2717,25460,109658,109365,293,163440000,162780000,660000
2020-11-01,Samut Prakan ,central,0.2703,47748,134999,134787,212,228860000,228460000,400000
2020-11-01,Samut Sakhon ,central,0.2394,28403,74599,74418,181,114930000,114710000,220000
2020-11-01,Chachoengsao ,east,0.3461,29200,308268,308090,178,446940000,446670000,270000
2020-11-01,Ratchaburi ,central,0.478,85348,156576,156489,87,242070000,241790000,280000
2020-11-01,Kanchanaburi ,central,0.5831000000000001,249372,749515,749389,126,1676380000,1675610000,770000
2020-11-01,Samut Songkhram ,central,0.5565,78670,199524,199380,144,215490000,215240000,250000
2020-11-01,Suphan Buri ,central,0.5458,78661,355700,355557,143,420820000,420550000,270000
2020-11-01,Phetchaburi ,central,0.5472,277726,593905,593356,549,1787650000,1783240000,4410000
2020-11-01,Prachuap Khiri Khan ,central,0.5035000000000001,361113,546882,546754,128,2317850000,2316350000,1500000
2020-11-01,Chonburi ,east,0.33159999999999995,593135,964084,947283,16801,5174040000,4859960000,314080000
2020-11-01,Chanthaburi ,east,0.4102,118169,157162,156724,438,464960000,463080000,1880000
2020-11-01,Trat ,east,0.33,103150,121862,120979,883,784510000,770680000,13830000
2020-11-01,Nakhon Nayok ,east,0.4769,101018,193816,193617,199,368070000,367250000,820000
2020-11-01,Prachinburi ,east,0.4073,66646,119515,119499,16,315060000,314980000,80000
2020-11-01,Rayong ,east,0.3826,236366,474423,473139,1284,2209430000,2198630000,10800000
2020-11-01,Sa Kaeo ,east,0.25730000000000003,33992,90455,90430,25,276320000,276260000,60000
2020-11-01,Phuket ,south,0.1184,156307,194994,192622,2372,1706180000,1628520000,77660000
2020-11-01,Phatthalung ,south,0.4475,52579,98339,98324,15,162280000,162260000,20000
2020-11-01,Trang ,south,0.3346,45172,59481,59381,100,257230000,256840000,390000
2020-11-01,Ranong ,south,0.1631,18586,23731,23497,234,67180000,66560000,620000
2020-11-01,Chumphon ,south,0.2736,44648,57456,57363,93,241600000,241270000,330000
2020-11-01,Pattani ,south,0.22920000000000001,9515,12129,12077,52,38090000,38020000,70000
2020-11-01,Yala ,south,0.5445,69102,90091,90037,54,247990000,247930000,60000
2020-11-01,Nakhon Si Thammarat ,south,0.5921,200227,289957,289745,212,1145280000,1144110000,1170000
2020-11-01,Narathiwat ,south,0.1343,13021,14398,14375,23,44930000,44900000,30000
2020-11-01,Krabi ,south,0.1158,55765,76572,75762,810,967660000,955840000,11820000
2020-11-01,Songkhla ,south,0.2749,164094,237914,236144,1770,1516520000,1498220000,18300000
2020-11-01,Phang Nga ,south,0.1623,28106,78706,77458,1248,288030000,275350000,12680000
2020-11-01,Surat Thani ,south,0.1565,104288,131933,126621,5312,790510000,725820000,64690000
2020-11-01,Satun ,south,0.414,54052,89720,88792,928,406700000,404650000,2050000
2020-11-01,Kamphaeng Phet ,north,0.36579999999999996,31894,63660,63419,241,124470000,124050000,420000
2020-11-01,Chiang Rai ,north,0.5974,226721,287466,285656,1810,2192400000,2178530000,13870000
2020-11-01,Chiang Mai ,north,0.7028,583901,926358,917933,8425,6831530000,6773390000,58140000
2020-11-01,Phichit ,north,0.4103,28804,62797,62797,0,112090000,112090000,0
2020-11-01,Nakhon Sawan ,north,0.46740000000000004,64975,121619,121430,189,274220000,273570000,650000
2020-11-01,Tak ,north,0.5404,118806,152796,152619,177,486230000,485450000,780000
2020-11-01,Phitsanulok ,north,0.4951,108763,189397,188951,446,526460000,525180000,1280000
2020-11-01,Phayao ,north,0.4678,25537,52745,52522,223,121080000,120680000,400000
2020-11-01,Phetchabun ,north,0.5864,178433,199884,199205,679,587610000,585740000,1870000
2020-11-01,Phrae ,north,0.6043,29269,67112,66945,167,131270000,131000000,270000
2020-11-01,Lampang ,north,0.6075,49447,136106,135280,826,401570000,397820000,3750000
2020-11-01,Lamphun ,north,0.5483,20369,107026,106248,778,150290000,149180000,1110000
2020-11-01,Mae Hong Son ,north,0.5720000000000001,106318,108946,108232,714,421350000,417650000,3700000
2020-11-01,Uttaradit ,north,0.47100000000000003,56736,81062,81062,0,139880000,139880000,0
2020-11-01,Uthai Thani ,north,0.5136,26452,66466,66398,68,118710000,118550000,160000
2020-11-01,Sukhothai ,north,0.49369999999999997,61740,90111,89212,899,277310000,275080000,2230000
2020-11-01,Nan ,north,0.7043,82848,101141,101003,138,223710000,222930000,780000
2020-11-01,Kalasin ,east_northeast,0.3283,16513,45250,45250,0,63440000,63440000,0
2020-11-01,Khon Kaen ,east_northeast,0.5264,157365,371955,371694,261,1026260000,1025250000,1010000
2020-11-01,Chaiyaphum ,east_northeast,0.36310000000000003,61301,107475,107475,0,151240000,151240000,0
2020-11-01,Nakhon Phanom ,east_northeast,0.5139,34452,89246,89155,91,130230000,129950000,280000
2020-11-01,Nakhon Ratchasima ,east_northeast,0.5204,377642,618902,617696,1206,1232320000,1227470000,4850000
2020-11-01,Buriram ,east_northeast,0.39840000000000003,68306,136509,136449,60,278300000,277710000,590000
2020-11-01,Maha Sarakham ,east_northeast,0.4334,36067,66610,66610,0,94860000,94860000,0
2020-11-01,Mukdahan ,east_northeast,0.32020000000000004,26608,100551,100551,0,142870000,142870000,0
2020-11-01,Roi Et ,east_northeast,0.3922,30810,80332,80332,0,105960000,105960000,0
2020-11-01,Loei ,east_northeast,0.6531,135083,239853,239666,187,397380000,396730000,650000
2020-11-01,Sisaket ,south,0.3754,23829,66341,66341,0,86070000,86070000,0
2020-11-01,Surin ,east_northeast,0.4266,71275,93846,93811,35,195780000,195710000,70000
2020-11-01,Nong Khai ,east_northeast,0.48710000000000003,76764,181591,181425,166,297070000,296620000,450000
2020-11-01,Bueng Kan ,east_northeast,0.5239,27863,51684,51620,64,71730000,71630000,100000
2020-11-01,Udon Thani ,east_northeast,0.5922,141007,320502,320327,175,786690000,786140000,550000
2020-11-01,Ubon Ratchathani ,east_northeast,0.4814,99952,205212,205146,66,305590000,305450000,140000
2020-11-01,Sakon Nakhon ,east_northeast,0.44789999999999996,49081,98847,98772,75,153790000,153660000,130000
2020-11-01,Yasothon ,east_northeast,0.30469999999999997,9860,30272,30272,0,30380000,30380000,0
2020-11-01,Amnat Charoen ,east_northeast,0.30870000000000003,5787,24560,24560,0,35230000,35230000,0
2020-11-01,Nong Bua Lamphu ,east_northeast,0.29969999999999997,9424,27671,27638,33,23620000,23580000,40000
2020-12-01,Bangkok,central,0.22820000000000001,946689,2300191,2235930,64261,13756260000,11958580000,1797680000
2020-12-01,Lopburi ,central,0.41759999999999997,47631,272409,271846,563,374090000,373260000,830000
2020-12-01,Phra Nakhon Si Ayutthaya ,central,0.4202,60653,367888,367464,424,675970000,674660000,1310000
2020-12-01,Saraburi ,central,0.32,61031,291257,290886,371,415410000,414750000,660000
2020-12-01,Chainat ,central,0.3354,13468,49823,49823,0,70750000,70750000,0
2020-12-01,Nakhon Pathom ,central,0.3897,67022,200417,200175,242,283910000,283030000,880000
2020-12-01,Sing Buri ,central,0.2845,6422,27403,27403,0,47010000,47010000,0
2020-12-01,Ang Thong ,central,0.1794,5061,38975,38975,0,42800000,42800000,0
2020-12-01,Nonthaburi ,central,0.3427,52760,148483,148036,447,202310000,201540000,770000
2020-12-01,Pathum Thani ,central,0.2306,23277,92686,91953,733,139270000,137450000,1820000
2020-12-01,Samut Prakan ,central,0.2511,44205,127038,126756,282,212900000,212530000,370000
2020-12-01,Samut Sakhon ,central,0.0676,8509,5132,5071,61,8960000,8880000,80000
2020-12-01,Chachoengsao ,east,0.30670000000000003,23032,289503,289337,166,416680000,416410000,270000
2020-12-01,Ratchaburi ,central,0.4227,74582,133674,133625,49,209000000,208840000,160000
2020-12-01,Kanchanaburi ,central,0.5457,221651,676977,676852,125,1504770000,1504000000,770000
2020-12-01,Samut Songkhram ,central,0.4806,65518,166811,166732,79,179950000,179800000,150000
2020-12-01,Suphan Buri ,central,0.4796,70635,272344,272131,213,326460000,326040000,420000
2020-12-01,Phetchaburi ,central,0.4802,240753,468674,468362,312,1481080000,1478530000,2550000
2020-12-01,Prachuap Khiri Khan ,central,0.441,318247,467840,467767,73,1975050000,1974200000,850000
2020-12-01,Chonburi ,east,0.3053,528203,844621,837365,7256,4490810000,4356330000,134480000
2020-12-01,Chanthaburi ,east,0.36119999999999997,89898,119686,119337,349,353880000,352390000,1490000
2020-12-01,Trat ,east,0.3395,103392,122191,121627,564,783660000,774820000,8840000
2020-12-01,Nakhon Nayok ,east,0.40020000000000006,81766,156633,156186,447,298210000,296380000,1830000
2020-12-01,Prachinburi ,east,0.3403,55694,99865,99822,43,263330000,263110000,220000
2020-12-01,Rayong ,east,0.3161,192633,376428,375662,766,1742570000,1736090000,6480000
2020-12-01,Sa Kaeo ,east,0.3345,42465,112733,112704,29,344760000,344690000,70000
2020-12-01,Phuket ,south,0.10830000000000001,148645,183111,181465,1646,1585840000,1531590000,54250000
2020-12-01,Phatthalung ,south,0.4093,45437,69140,69140,0,118890000,118890000,0
2020-12-01,Trang ,south,0.3071,42136,51810,51732,78,231720000,231420000,300000
2020-12-01,Ranong ,south,0.152,16366,21283,21139,144,59510000,59130000,380000
2020-12-01,Chumphon ,south,0.22760000000000002,39479,50501,50449,52,217190000,217010000,180000
2020-12-01,Pattani ,south,0.2231,8663,10833,10795,38,33880000,33830000,50000
2020-12-01,Yala ,south,0.5611,72895,98035,97984,51,259430000,259360000,70000
2020-12-01,Nakhon Si Thammarat ,south,0.5466,190821,275318,275294,24,1074210000,1074080000,130000
2020-12-01,Narathiwat ,south,0.1117,10881,12046,12013,33,37320000,37280000,40000
2020-12-01,Krabi ,south,0.1167,60367,79118,78755,363,991460000,986100000,5360000
2020-12-01,Songkhla ,south,0.25079999999999997,164174,229280,228955,325,1485030000,1481670000,3360000
2020-12-01,Phang Nga ,south,0.1736,30215,92181,90813,1368,320790000,306630000,14160000
2020-12-01,Surat Thani ,south,0.131,93616,135147,134141,1006,760850000,748760000,12090000
2020-12-01,Satun ,south,0.3933,51402,84445,84345,100,377550000,377320000,230000
2020-12-01,Kamphaeng Phet ,north,0.3921,34564,65543,65351,192,122070000,121740000,330000
2020-12-01,Chiang Rai ,north,0.5577000000000001,208058,267702,266424,1278,2062980000,2053250000,9730000
2020-12-01,Chiang Mai ,north,0.6565000000000001,537846,960312,956581,3731,6944190000,6918390000,25800000
2020-12-01,Phichit ,north,0.4113,23691,59441,59441,0,106480000,106480000,0
2020-12-01,Nakhon Sawan ,north,0.4307,59931,114226,114026,200,258520000,257820000,700000
2020-12-01,Tak ,north,0.4976,101076,129096,128957,139,405170000,404550000,620000
2020-12-01,Phitsanulok ,north,0.462,106071,182816,182461,355,496670000,495680000,990000
2020-12-01,Phayao ,north,0.382,19363,40008,39759,249,89220000,88750000,470000
2020-12-01,Phetchabun ,north,0.5806,173990,192131,191702,429,576110000,574900000,1210000
2020-12-01,Phrae ,north,0.5635,38973,89563,89433,130,173410000,173190000,220000
2020-12-01,Lampang ,north,0.5507,43286,122530,122124,406,340130000,338270000,1860000
2020-12-01,Lamphun ,north,0.46159999999999995,16547,80480,79942,538,108630000,107830000,800000
2020-12-01,Mae Hong Son ,north,0.4192,77183,79996,79098,898,318630000,314090000,4540000
2020-12-01,Uttaradit ,north,0.4152,46310,66533,66533,0,110710000,110710000,0
2020-12-01,Uthai Thani ,north,0.4276,20269,53344,53344,0,91090000,91090000,0
2020-12-01,Sukhothai ,north,0.48090000000000005,56696,83911,82458,1453,254560000,250780000,3780000
2020-12-01,Nan ,north,0.5799,68667,83822,83721,101,175370000,174790000,580000
2020-12-01,Kalasin ,east_northeast,0.3407,15834,44089,44089,0,61190000,61190000,0
2020-12-01,Khon Kaen ,east_northeast,0.4953,150209,340305,340172,133,958030000,957520000,510000
2020-12-01,Chaiyaphum ,east_northeast,0.3789,63667,111044,111044,0,156720000,156720000,0
2020-12-01,Nakhon Phanom ,east_northeast,0.5259,35059,90733,90639,94,132450000,132160000,290000
2020-12-01,Nakhon Ratchasima ,east_northeast,0.5438000000000001,390347,639896,638571,1325,1274190000,1268950000,5240000
2020-12-01,Buriram ,east_northeast,0.40369999999999995,69867,140023,139976,47,284800000,284340000,460000
2020-12-01,Maha Sarakham ,east_northeast,0.4113,33643,65449,65449,0,89840000,89840000,0
2020-12-01,Mukdahan ,east_northeast,0.3418,27225,102663,102663,0,146000000,146000000,0
2020-12-01,Roi Et ,east_northeast,0.40950000000000003,32321,84050,84050,0,111060000,111060000,0
2020-12-01,Loei ,east_northeast,0.6509,132406,258053,257968,85,415030000,414730000,300000
2020-12-01,Sisaket ,south,0.41409999999999997,24940,69434,69434,0,90080000,90080000,0
2020-12-01,Surin ,east_northeast,0.4156,63694,83871,83823,48,174970000,174870000,100000
2020-12-01,Nong Khai ,east_northeast,0.5429999999999999,80205,189605,189478,127,310210000,309860000,350000
2020-12-01,Bueng Kan ,east_northeast,0.5322,28191,52253,52227,26,72520000,72480000,40000
2020-12-01,Udon Thani ,east_northeast,0.6339,157294,357463,357261,202,877520000,876880000,640000
2020-12-01,Ubon Ratchathani ,east_northeast,0.4288,90999,181451,181379,72,273240000,273080000,160000
2020-12-01,Sakon Nakhon ,east_northeast,0.4388,48720,121130,121028,102,164850000,164670000,180000
2020-12-01,Yasothon ,east_northeast,0.3543,13667,41960,41960,0,42110000,42110000,0
2020-12-01,Amnat Charoen ,east_northeast,0.3568,6690,28237,28237,0,40650000,40650000,0
2020-12-01,Nong Bua Lamphu ,east_northeast,0.3308,10855,31864,31839,25,27190000,27160000,30000
2021-01-01,Bangkok,central,0.0754,354676,1681847,1632693,49154,9539730000,8447450000,1092280000
2021-01-01,Lopburi ,central,0.2048,19467,69397,69330,67,86930000,86850000,80000
2021-01-01,Phra Nakhon Si Ayutthaya ,central,0.1816,30074,224085,223816,269,376740000,376120000,620000
2021-01-01,Saraburi ,central,0.1905,29441,95027,95004,23,147910000,147880000,30000
2021-01-01,Chainat ,central,0.1613,6508,31718,31718,0,40530000,40530000,0
2021-01-01,Nakhon Pathom ,central,0.1653,27769,86717,86682,35,116740000,116640000,100000
2021-01-01,Sing Buri ,central,0.1182,2765,16311,16311,0,21920000,21920000,0
2021-01-01,Ang Thong ,central,0.0538,1516,26723,26723,0,26380000,26380000,0
2021-01-01,Nonthaburi ,central,0.0583,8450,67342,67342,0,77120000,77120000,0
2021-01-01,Pathum Thani ,central,0.0781,8146,51042,51042,0,65140000,65140000,0
2021-01-01,Samut Prakan ,central,0.0552,9972,38836,38754,82,55670000,55570000,100000
2021-01-01,Samut Sakhon ,central,0.0,0,0,0,0,0,0,0
2021-01-01,Chachoengsao ,east,0.0482,3743,49532,49532,0,59240000,59240000,0
2021-01-01,Ratchaburi ,central,0.1689,29734,52247,52232,15,75310000,75290000,20000
2021-01-01,Kanchanaburi ,central,0.1286,52133,355312,355269,43,771630000,771470000,160000
2021-01-01,Samut Songkhram ,central,0.0338,4607,88446,88446,0,89010000,89010000,0
2021-01-01,Suphan Buri ,central,0.0862,12983,104311,104303,8,119330000,119320000,10000
2021-01-01,Phetchaburi ,central,0.20379999999999998,99682,224595,224333,262,707490000,705790000,1700000
2021-01-01,Prachuap Khiri Khan ,central,0.10619999999999999,76887,270283,270217,66,1160740000,1160000000,740000
2021-01-01,Chonburi ,east,0.0092,14560,25035,23674,1361,148130000,126190000,21940000
2021-01-01,Chanthaburi ,east,0.0,0,0,0,0,0,0,0
2021-01-01,Trat ,east,0.0123,3792,4473,4473,0,28330000,28330000,0
2021-01-01,Nakhon Nayok ,east,0.28559999999999997,30124,57729,57729,0,116410000,116410000,0
2021-01-01,Prachinburi ,east,0.2402,38804,69590,69590,0,183430000,183430000,0
2021-01-01,Rayong ,east,0.0704,35201,39491,39491,0,145780000,145780000,0
2021-01-01,Sa Kaeo ,east,0.1981,16455,43687,43687,0,142970000,142970000,0
2021-01-01,Phuket ,south,0.0245,35865,45616,44668,948,402500000,374910000,27590000
2021-01-01,Phatthalung ,south,0.22519999999999998,25274,40008,40008,0,55060000,55060000,0
2021-01-01,Trang ,south,0.1533,21035,25074,25036,38,110700000,110560000,140000
2021-01-01,Ranong ,south,0.10310000000000001,11199,12727,12680,47,34640000,34530000,110000
2021-01-01,Chumphon ,south,0.12480000000000001,22204,27748,27735,13,89380000,89340000,40000
2021-01-01,Pattani ,south,0.19399999999999998,7569,8723,8723,0,26820000,26820000,0
2021-01-01,Yala ,south,0.1514,19750,26875,26875,0,69180000,69180000,0
2021-01-01,Nakhon Si Thammarat ,south,0.25730000000000003,88909,128776,128776,0,442880000,442880000,0
2021-01-01,Narathiwat ,south,0.1057,10144,10928,10928,0,26920000,26920000,0
2021-01-01,Krabi ,south,0.0421,22440,31788,31573,215,395730000,393050000,2680000
2021-01-01,Songkhla ,south,0.11359999999999999,76275,108056,107936,120,692180000,691080000,1100000
2021-01-01,Phang Nga ,south,0.08449999999999999,15574,46699,46142,557,157230000,152920000,4310000
2021-01-01,Surat Thani ,south,0.0557,39640,59009,58633,376,326690000,322860000,3830000
2021-01-01,Satun ,south,0.17489999999999997,23393,39776,39744,32,176000000,175850000,150000
2021-01-01,Kamphaeng Phet ,north,0.1288,11298,20881,20822,59,37570000,37470000,100000
2021-01-01,Chiang Rai ,north,0.2297,85580,108859,108363,496,754520000,749570000,4950000
2021-01-01,Chiang Mai ,north,0.2075,169056,301589,298961,2628,2097880000,2076110000,21770000
2021-01-01,Phichit ,north,0.2334,13398,31070,31070,0,53440000,53440000,0
2021-01-01,Nakhon Sawan ,north,0.23620000000000002,32834,63447,63377,70,109810000,109550000,260000
2021-01-01,Tak ,north,0.1318,26915,35842,35807,35,110320000,110160000,160000
2021-01-01,Phitsanulok ,north,0.2852,65846,114045,113901,144,258330000,257950000,380000
2021-01-01,Phayao ,north,0.1943,9892,20547,20468,79,38460000,38290000,170000
2021-01-01,Phetchabun ,north,0.1681,52899,58846,58588,258,167560000,166780000,780000
2021-01-01,Phrae ,north,0.11,7655,20824,20767,57,40240000,40150000,90000
2021-01-01,Lampang ,north,0.2398,18958,56736,56511,225,155100000,154090000,1010000
2021-01-01,Lamphun ,north,0.2096,7492,33385,33142,243,43850000,43490000,360000
2021-01-01,Mae Hong Son ,north,0.1348,24832,26007,25552,455,102570000,100280000,2290000
2021-01-01,Uttaradit ,north,0.16390000000000002,18221,27391,27391,0,43850000,43850000,0
2021-01-01,Uthai Thani ,north,0.2325,10877,27870,27870,0,46800000,46800000,0
2021-01-01,Sukhothai ,north,0.1725,20335,31084,30571,513,58310000,57010000,1300000
2021-01-01,Nan ,north,0.1052,12457,15209,15168,41,29900000,29660000,240000
2021-01-01,Kalasin ,east_northeast,0.20190000000000002,9395,25745,25745,0,34720000,34720000,0
2021-01-01,Khon Kaen ,east_northeast,0.2288,69648,123419,123367,52,342130000,341940000,190000
2021-01-01,Chaiyaphum ,east_northeast,0.19510000000000002,32747,64400,64400,0,78780000,78780000,0
2021-01-01,Nakhon Phanom ,east_northeast,0.2615,17401,46811,46762,49,67100000,67010000,90000
2021-01-01,Nakhon Ratchasima ,east_northeast,0.31579999999999997,227743,373146,372592,554,703270000,701810000,1460000
2021-01-01,Buriram ,east_northeast,0.30329999999999996,52498,100988,100958,30,203810000,203760000,50000
2021-01-01,Maha Sarakham ,east_northeast,0.15380000000000002,12533,23636,23636,0,30950000,30950000,0
2021-01-01,Mukdahan ,east_northeast,0.1993,15899,59954,59954,0,87660000,87660000,0
2021-01-01,Roi Et ,east_northeast,0.3032,24004,62422,62422,0,86900000,86900000,0
2021-01-01,Loei ,east_northeast,0.0913,19730,65048,65018,30,100860000,100750000,110000
2021-01-01,Sisaket ,south,0.3018,18073,50317,50317,0,64120000,64120000,0
2021-01-01,Surin ,east_northeast,0.24480000000000002,37407,49262,49222,40,100710000,100640000,70000
2021-01-01,Nong Khai ,east_northeast,0.1274,18767,43888,43837,51,71110000,71030000,80000
2021-01-01,Bueng Kan ,east_northeast,0.1693,9087,18017,18017,0,24060000,24060000,0
2021-01-01,Udon Thani ,east_northeast,0.18309999999999998,45693,104203,104169,34,265610000,265510000,100000
2021-01-01,Ubon Ratchathani ,east_northeast,0.3053,65301,143281,143261,20,208180000,208140000,40000
2021-01-01,Sakon Nakhon ,east_northeast,0.1681,18650,60562,60511,51,81110000,81030000,80000
2021-01-01,Yasothon ,east_northeast,0.2822,10006,30720,30720,0,31690000,31690000,0
2021-01-01,Amnat Charoen ,east_northeast,0.2661,5002,20364,20364,0,28540000,28540000,0
2021-01-01,Nong Bua Lamphu ,east_northeast,0.0473,1547,4539,4539,0,3700000,3700000,0
2021-02-01,Bangkok,central,0.0998,484142,1984032,1933535,50497,10951940000,9799710000,1152230000
2021-02-01,Lopburi ,central,0.312,29999,131574,131532,42,169800000,169750000,50000
2021-02-01,Phra Nakhon Si Ayutthaya ,central,0.2504,42183,192677,192540,137,357180000,356830000,350000
2021-02-01,Saraburi ,central,0.2682,40942,115279,115234,45,181410000,181340000,70000
2021-02-01,Chainat ,central,0.33049999999999996,13303,49394,49394,0,68030000,68030000,0
2021-02-01,Nakhon Pathom ,central,0.30519999999999997,50136,169132,169071,61,222470000,222290000,180000
2021-02-01,Sing Buri ,central,0.2978,6400,27336,27336,0,38280000,38280000,0
2021-02-01,Ang Thong ,central,0.213,4619,39898,39898,0,45040000,45040000,0
2021-02-01,Nonthaburi ,central,0.0851,12609,77070,77000,70,96340000,96250000,90000
2021-02-01,Pathum Thani ,central,0.12179999999999999,12583,63182,63096,86,80780000,80560000,220000
2021-02-01,Samut Prakan ,central,0.09960000000000001,17372,57812,57697,115,86870000,86750000,120000
2021-02-01,Samut Sakhon ,central,0.017,2190,8190,8190,0,12130000,12130000,0
2021-02-01,Chachoengsao ,east,0.1013,7650,80357,80357,0,96250000,96250000,0
2021-02-01,Ratchaburi ,central,0.2557,38928,68399,68384,15,98600000,98570000,30000
2021-02-01,Kanchanaburi ,central,0.3007,122167,464148,463793,355,1277810000,1276730000,1080000
2021-02-01,Samut Songkhram ,central,0.1149,15673,116259,115988,271,120400000,119800000,600000
2021-02-01,Suphan Buri ,central,0.1967,29021,135782,135683,99,160220000,160050000,170000
2021-02-01,Phetchaburi ,central,0.3843,188659,448354,448063,291,1371200000,1369020000,2180000
2021-02-01,Prachuap Khiri Khan ,central,0.3381,207590,294666,294520,146,1371190000,1368970000,2220000
2021-02-01,Chonburi ,east,0.0313,49449,87030,85561,1469,415470000,392070000,23400000
2021-02-01,Chanthaburi ,east,0.22030000000000002,48190,63893,63808,85,213630000,213370000,260000
2021-02-01,Trat ,east,0.19269999999999998,55347,65263,64745,518,388270000,380930000,7340000
2021-02-01,Nakhon Nayok ,east,0.30329999999999996,30376,67468,67468,0,122090000,122090000,0
2021-02-01,Prachinburi ,east,0.2409,39290,70462,70462,0,165630000,165630000,0
2021-02-01,Rayong ,east,0.1463,55721,75268,75016,252,263750000,262400000,1350000
2021-02-01,Sa Kaeo ,east,0.2041,15230,40434,40434,0,129270000,129270000,0
2021-02-01,Phuket ,south,0.0452,50502,63450,62393,1057,589750000,558990000,30760000
2021-02-01,Phatthalung ,south,0.32420000000000004,36080,73574,73574,0,109700000,109700000,0
2021-02-01,Trang ,south,0.26289999999999997,34229,46083,46045,38,207490000,207340000,150000
2021-02-01,Ranong ,south,0.151,16296,18615,18583,32,50550000,50470000,80000
2021-02-01,Chumphon ,south,0.2052,34230,42671,42661,10,138520000,138490000,30000
2021-02-01,Pattani ,south,0.2298,8917,11855,11855,0,36980000,36980000,0
2021-02-01,Yala ,south,0.2849,36966,42595,42595,0,118130000,118130000,0
2021-02-01,Nakhon Si Thammarat ,south,0.32880000000000004,114775,166095,166095,0,589580000,589580000,0
2021-02-01,Narathiwat ,south,0.1757,17159,19389,19389,0,46900000,46900000,0
2021-02-01,Krabi ,south,0.0634,27499,39715,39524,191,487160000,484780000,2380000
2021-02-01,Songkhla ,south,0.1157,56131,78209,78144,65,501170000,500570000,600000
2021-02-01,Phang Nga ,south,0.09939999999999999,18116,59190,58785,405,221890000,218470000,3420000
2021-02-01,Surat Thani ,south,0.06709999999999999,47902,70660,70067,593,393770000,389090000,4680000
2021-02-01,Satun ,south,0.3379,41709,69526,69494,32,314170000,314040000,130000
2021-02-01,Kamphaeng Phet ,north,0.1409,12320,22763,22722,41,41140000,41070000,70000
2021-02-01,Chiang Rai ,north,0.2351,87672,111446,111062,384,762070000,757760000,4310000
2021-02-01,Chiang Mai ,north,0.2551,208372,372311,369567,2744,2552100000,2529210000,22890000
2021-02-01,Phichit ,north,0.3245,18713,43396,43396,0,80520000,80520000,0
2021-02-01,Nakhon Sawan ,north,0.3518,48845,93406,93316,90,164030000,163690000,340000
2021-02-01,Tak ,north,0.1555,31873,50089,50031,58,140490000,140240000,250000
2021-02-01,Phitsanulok ,north,0.2993,69183,119720,119623,97,261860000,261580000,280000
2021-02-01,Phayao ,north,0.2216,11179,25863,25773,90,46540000,46300000,240000
2021-02-01,Phetchabun ,north,0.2418,75011,84124,83859,265,251940000,251070000,870000
2021-02-01,Phrae ,north,0.2945,20153,48250,48136,114,99560000,99360000,200000
2021-02-01,Lampang ,north,0.2962,23272,72438,72016,422,198560000,196840000,1720000
2021-02-01,Lamphun ,north,0.3193,11389,54683,54569,114,71740000,71550000,190000
2021-02-01,Mae Hong Son ,north,0.2113,38873,40403,40002,401,157990000,155870000,2120000
2021-02-01,Uttaradit ,north,0.23629999999999998,26259,38592,38592,0,62560000,62560000,0
2021-02-01,Uthai Thani ,north,0.3346,15503,39446,39446,0,66440000,66440000,0
2021-02-01,Sukhothai ,north,0.17670000000000002,20845,32784,32324,460,60620000,59400000,1220000
2021-02-01,Nan ,north,0.3045,36069,44036,43969,67,86300000,85970000,330000
2021-02-01,Kalasin ,east_northeast,0.29510000000000003,13760,38961,38961,0,51480000,51480000,0
2021-02-01,Khon Kaen ,east_northeast,0.2716,82871,163948,163896,52,443520000,443340000,180000
2021-02-01,Chaiyaphum ,east_northeast,0.22399999999999998,37615,56755,56691,64,66230000,66100000,130000
2021-02-01,Nakhon Phanom ,east_northeast,0.3289,21941,58109,58060,49,85440000,85360000,80000
2021-02-01,Nakhon Ratchasima ,east_northeast,0.3973,286262,469188,468263,925,898730000,896570000,2160000
2021-02-01,Buriram ,east_northeast,0.3428,59337,116297,116158,139,243390000,243150000,240000
2021-02-01,Maha Sarakham ,east_northeast,0.2047,16748,31586,31586,0,42540000,42540000,0
2021-02-01,Mukdahan ,east_northeast,0.3321,26480,99854,99854,0,147500000,147500000,0
2021-02-01,Roi Et ,east_northeast,0.316,25065,54756,54756,0,78900000,78900000,0
2021-02-01,Loei ,east_northeast,0.1845,40118,101053,101023,30,170220000,170110000,110000
2021-02-01,Sisaket ,south,0.3284,19463,54186,54186,0,70550000,70550000,0
2021-02-01,Surin ,east_northeast,0.3012,46138,60763,60706,57,128750000,128660000,90000
2021-02-01,Nong Khai ,east_northeast,0.2625,38777,90741,90603,138,147010000,146810000,200000
2021-02-01,Bueng Kan ,east_northeast,0.25780000000000003,13484,26009,26009,0,37920000,37920000,0
2021-02-01,Udon Thani ,east_northeast,0.2634,65395,148903,148869,34,379920000,379820000,100000
2021-02-01,Ubon Ratchathani ,east_northeast,0.3135,66768,147174,147154,20,213470000,213440000,30000
2021-02-01,Sakon Nakhon ,east_northeast,0.3234,35914,67345,67290,55,122720000,122610000,110000
2021-02-01,Yasothon ,east_northeast,0.259,9811,30121,30121,0,31560000,31560000,0
2021-02-01,Amnat Charoen ,east_northeast,0.2811,5283,18061,18061,0,26250000,26250000,0
2021-02-01,Nong Bua Lamphu ,east_northeast,0.0765,2511,7367,7367,0,6010000,6010000,0
2021-03-01,Bangkok,central,0.1487,553790,1985954,1927628,58326,11142910000,9845580000,1297330000
2021-03-01,Lopburi ,central,0.36219999999999997,32420,145967,145829,138,194140000,193970000,170000
2021-03-01,Phra Nakhon Si Ayutthaya ,central,0.3319,46175,403334,400981,2353,773080000,768020000,5060000
2021-03-01,Saraburi ,central,0.3465,47434,149563,149399,164,249620000,249400000,220000
2021-03-01,Chainat ,central,0.36729999999999996,14756,53173,53173,0,74090000,74090000,0
2021-03-01,Nakhon Pathom ,central,0.40149999999999997,55745,182808,182747,61,255530000,255380000,150000
2021-03-01,Sing Buri ,central,0.3443,7062,29344,29344,0,40920000,40920000,0
2021-03-01,Ang Thong ,central,0.3043,6545,52076,52076,0,60380000,60380000,0
2021-03-01,Nonthaburi ,central,0.12140000000000001,12079,91899,91708,191,121160000,120920000,240000
2021-03-01,Pathum Thani ,central,0.1298,11664,65074,64909,165,67570000,67150000,420000
2021-03-01,Samut Prakan ,central,0.11230000000000001,19098,66643,66373,270,100900000,100590000,310000
2021-03-01,Samut Sakhon ,central,0.0329,2849,9164,9164,0,14050000,14050000,0
2021-03-01,Chachoengsao ,east,0.1539,8038,86518,86518,0,96030000,96030000,0
2021-03-01,Ratchaburi ,central,0.3995,60452,106210,106195,15,156010000,155980000,30000
2021-03-01,Kanchanaburi ,central,0.35159999999999997,142877,525831,525583,248,1469780000,1469120000,660000
2021-03-01,Samut Songkhram ,central,0.19030000000000002,25970,141951,141879,72,150920000,150710000,210000
2021-03-01,Suphan Buri ,central,0.35340000000000005,52155,244088,244042,46,288750000,288670000,80000
2021-03-01,Phetchaburi ,central,0.5177,255248,638294,638044,250,1921140000,1919270000,1870000
2021-03-01,Prachuap Khiri Khan ,central,0.36619999999999997,225579,327856,327726,130,1575880000,1573950000,1930000
2021-03-01,Chonburi ,east,0.0647,89848,160334,158940,1394,768770000,746580000,22190000
2021-03-01,Chanthaburi ,east,0.3807,81769,108385,108293,92,314740000,314450000,290000
2021-03-01,Trat ,east,0.261,75150,88623,88255,368,533310000,528090000,5220000
2021-03-01,Nakhon Nayok ,east,0.358,36042,78933,78933,0,155230000,155230000,0
2021-03-01,Prachinburi ,east,0.30829999999999996,47379,84968,84968,0,207190000,207190000,0
2021-03-01,Rayong ,east,0.3068,69973,89968,89720,248,299710000,298470000,1240000
2021-03-01,Sa Kaeo ,east,0.2526,17874,47454,47454,0,130180000,130180000,0
2021-03-01,Phuket ,south,0.10859999999999999,121412,152376,151246,1130,1579050000,1541570000,37480000
2021-03-01,Phatthalung ,south,0.3643,40596,84601,84601,0,134040000,134040000,0
2021-03-01,Trang ,south,0.3271,41267,58195,58164,31,268870000,268750000,120000
2021-03-01,Ranong ,south,0.2071,26496,34749,34689,60,84230000,84070000,160000
2021-03-01,Chumphon ,south,0.2838,43938,57022,57004,18,172480000,172420000,60000
2021-03-01,Pattani ,south,0.405,15666,21056,21056,0,67360000,67360000,0
2021-03-01,Yala ,south,0.4336,56560,67418,67418,0,164040000,164040000,0
2021-03-01,Nakhon Si Thammarat ,south,0.38079999999999997,133068,190988,190988,0,670280000,670280000,0
2021-03-01,Narathiwat ,south,0.22390000000000002,18525,21581,21581,0,54830000,54830000,0
2021-03-01,Krabi ,south,0.1188,45238,65522,65358,164,821740000,819790000,1950000
2021-03-01,Songkhla ,south,0.17079999999999998,84367,121089,121035,54,776690000,776200000,490000
2021-03-01,Phang Nga ,south,0.23809999999999998,40255,138925,137933,992,531300000,517010000,14290000
2021-03-01,Surat Thani ,south,0.0874,60906,90739,90236,503,493230000,485020000,8210000
2021-03-01,Satun ,south,0.49950000000000006,61367,101763,101708,55,431190000,430890000,300000
2021-03-01,Kamphaeng Phet ,north,0.21350000000000002,20158,37399,37338,61,66000000,65890000,110000
2021-03-01,Chiang Rai ,north,0.24170000000000003,98200,125841,125368,473,868040000,862920000,5120000
2021-03-01,Chiang Mai ,north,0.2569,215872,386284,382766,3518,2757560000,2726820000,30740000
2021-03-01,Phichit ,north,0.3593,21622,50391,50391,0,89580000,89580000,0
2021-03-01,Nakhon Sawan ,north,0.3751,55399,106219,106117,102,177330000,176930000,400000
2021-03-01,Tak ,north,0.19760000000000003,40150,57363,57297,66,156280000,156000000,280000
2021-03-01,Phitsanulok ,north,0.3518,76306,130985,130868,117,280540000,280220000,320000
2021-03-01,Phayao ,north,0.2643,14072,32320,32210,110,56350000,56050000,300000
2021-03-01,Phetchabun ,north,0.258,80139,90644,90342,302,269870000,268900000,970000
2021-03-01,Phrae ,north,0.3578,24816,57836,57702,134,119100000,118860000,240000
2021-03-01,Lampang ,north,0.3547,28564,84906,84436,470,233730000,231880000,1850000
2021-03-01,Lamphun ,north,0.3469,13025,64048,63919,129,81300000,81080000,220000
2021-03-01,Mae Hong Son ,north,0.2114,16637,41546,41093,453,157780000,155400000,2380000
2021-03-01,Uttaradit ,north,0.2697,28730,42859,42859,0,65200000,65200000,0
2021-03-01,Uthai Thani ,north,0.42340000000000005,21291,53332,53332,0,88450000,88450000,0
2021-03-01,Sukhothai ,north,0.2845,32264,50993,50413,580,96990000,95550000,1440000
2021-03-01,Nan ,north,0.4078,47639,58627,58539,88,120620000,120190000,430000
2021-03-01,Kalasin ,east_northeast,0.3317,15424,43521,43521,0,58080000,58080000,0
2021-03-01,Khon Kaen ,east_northeast,0.3652,111100,250457,250372,85,676620000,676300000,320000
2021-03-01,Chaiyaphum ,east_northeast,0.2841,47670,71918,71852,66,78580000,78440000,140000
2021-03-01,Nakhon Phanom ,east_northeast,0.3558,23724,62551,62483,68,96580000,96460000,120000
2021-03-01,Nakhon Ratchasima ,east_northeast,0.4117,295870,484722,483081,1641,954290000,949960000,4330000
2021-03-01,Buriram ,east_northeast,0.524,90706,186790,186609,181,390320000,389980000,340000
2021-03-01,Maha Sarakham ,east_northeast,0.245,20090,37889,37889,0,54340000,54340000,0
2021-03-01,Mukdahan ,east_northeast,0.3003,23969,90384,90384,0,135320000,135320000,0
2021-03-01,Roi Et ,east_northeast,0.3893,30798,69664,69664,0,101780000,101780000,0
2021-03-01,Loei ,east_northeast,0.2125,46029,111490,111441,49,190360000,190180000,180000
2021-03-01,Sisaket ,south,0.408,24290,67625,67625,0,92110000,92110000,0
2021-03-01,Surin ,east_northeast,0.3345,51294,67540,67508,32,143690000,143640000,50000
2021-03-01,Nong Khai ,east_northeast,0.3703,54755,128106,127950,156,211570000,211340000,230000
2021-03-01,Bueng Kan ,east_northeast,0.3665,19342,36657,36657,0,55790000,55790000,0
2021-03-01,Udon Thani ,east_northeast,0.3987,98916,224961,224917,44,551870000,551740000,130000
2021-03-01,Ubon Ratchathani ,east_northeast,0.34130000000000005,72780,163126,163101,25,249900000,249850000,50000
2021-03-01,Sakon Nakhon ,east_northeast,0.33909999999999996,37649,70834,70778,56,133090000,132980000,110000
2021-03-01,Yasothon ,east_northeast,0.2717,9889,30361,30361,0,34360000,34360000,0
2021-03-01,Amnat Charoen ,east_northeast,0.254,4762,15940,15940,0,23800000,23800000,0
2021-03-01,Nong Bua Lamphu ,east_northeast,0.2027,6657,19531,19531,0,16520000,16520000,0
2021-04-01,Bangkok,central,0.1027,365605,1115611,1063854,51757,7302480000,6164500000,1137980000
2021-04-01,Lopburi ,central,0.10339999999999999,11244,54769,54707,62,69280000,69210000,70000
2021-04-01,Phra Nakhon Si Ayutthaya ,central,0.1728,23043,230549,229807,742,428290000,426650000,1640000
2021-04-01,Saraburi ,central,0.2039,26737,96839,96724,115,146900000,146740000,160000
2021-04-01,Chainat ,central,0.09720000000000001,5856,31521,31521,0,40790000,40790000,0
2021-04-01,Nakhon Pathom ,central,0.1263,25328,98319,98268,51,139240000,139140000,100000
2021-04-01,Sing Buri ,central,0.10830000000000001,2858,17847,17847,0,29660000,29660000,0
2021-04-01,Ang Thong ,central,0.15289999999999998,3358,35544,35544,0,38790000,38790000,0
2021-04-01,Nonthaburi ,central,0.0542,5158,33945,33820,125,48520000,48360000,160000
2021-04-01,Pathum Thani ,central,0.0554,5251,17584,17443,141,20220000,19860000,360000
2021-04-01,Samut Prakan ,central,0.0417,6824,27501,27263,238,48610000,48340000,270000
2021-04-01,Samut Sakhon ,central,0.026099999999999998,2182,6690,6639,51,10170000,10110000,60000
2021-04-01,Chachoengsao ,east,0.0727,3693,29877,29877,0,41080000,41080000,0
2021-04-01,Ratchaburi ,central,0.1472,22266,42340,42325,15,60030000,60000000,30000
2021-04-01,Kanchanaburi ,central,0.2028,82703,243519,243308,211,674700000,674190000,510000
2021-04-01,Samut Songkhram ,central,0.1449,19762,126386,126314,72,133240000,133040000,200000
2021-04-01,Suphan Buri ,central,0.1143,16690,72907,72907,0,85940000,85940000,0
2021-04-01,Phetchaburi ,central,0.3419,166685,385714,385488,226,1133770000,1132080000,1690000
2021-04-01,Prachuap Khiri Khan ,central,0.3046,186276,275365,275243,122,1333140000,1331470000,1670000
2021-04-01,Chonburi ,east,0.0611,84428,156392,155350,1042,862010000,845210000,16800000
2021-04-01,Chanthaburi ,east,0.40740000000000004,87520,116001,115931,70,345080000,344880000,200000
2021-04-01,Trat ,east,0.405,116677,137616,137392,224,804490000,801460000,3030000
2021-04-01,Nakhon Nayok ,east,0.35159999999999997,35350,76708,76708,0,151450000,151450000,0
2021-04-01,Prachinburi ,east,0.2267,35050,62857,62857,0,147760000,147760000,0
2021-04-01,Rayong ,east,0.3084,70386,102268,101970,298,468430000,467000000,1430000
2021-04-01,Sa Kaeo ,east,0.1244,8829,23441,23441,0,59280000,59280000,0
2021-04-01,Phuket ,south,0.13419999999999999,147051,185057,183877,1180,2025260000,1986220000,39040000
2021-04-01,Phatthalung ,south,0.15560000000000002,16809,50714,50714,0,82670000,82670000,0
2021-04-01,Trang ,south,0.2576,31449,40640,40547,93,197580000,197230000,350000
2021-04-01,Ranong ,south,0.33409999999999995,41678,52522,52361,161,129730000,129320000,410000
2021-04-01,Chumphon ,south,0.3157,47162,61047,60995,52,179920000,179750000,170000
2021-04-01,Pattani ,south,0.2562,9628,11318,11318,0,37720000,37720000,0
2021-04-01,Yala ,south,0.201,25310,29789,29789,0,85400000,85400000,0
2021-04-01,Nakhon Si Thammarat ,south,0.2184,73990,108124,107604,520,450280000,448780000,1500000
2021-04-01,Narathiwat ,south,0.1355,10819,12366,12366,0,34970000,34970000,0
2021-04-01,Krabi ,south,0.2036,73038,100764,99754,1010,1344930000,1332990000,11940000
2021-04-01,Songkhla ,south,0.09570000000000001,45818,69929,69891,38,475770000,475430000,340000
2021-04-01,Phang Nga ,south,0.2671,43419,132253,130614,1639,568640000,545130000,23510000
2021-04-01,Surat Thani ,south,0.0724,47781,65669,65132,537,380330000,371620000,8710000
2021-04-01,Satun ,south,0.3075,36470,73143,72554,589,327130000,323990000,3140000
2021-04-01,Kamphaeng Phet ,north,0.0583,5925,39769,39688,81,71680000,71530000,150000
2021-04-01,Chiang Rai ,north,0.1346,56829,132092,131542,550,973660000,967450000,6210000
2021-04-01,Chiang Mai ,north,0.1076,98238,396241,392204,4037,2876760000,2841260000,35500000
2021-04-01,Phichit ,north,0.10339999999999999,6953,52325,52325,0,90750000,90750000,0
2021-04-01,Nakhon Sawan ,north,0.1359,19825,115116,115001,115,218330000,217890000,440000
2021-04-01,Tak ,north,0.1623,29862,59385,59312,73,165110000,164810000,300000
2021-04-01,Phitsanulok ,north,0.28850000000000003,62527,150029,149890,139,369280000,368920000,360000
2021-04-01,Phayao ,north,0.15289999999999998,7810,34541,34442,99,70320000,70010000,310000
2021-04-01,Phetchabun ,north,0.19870000000000002,59892,95174,94812,362,287560000,286470000,1090000
2021-04-01,Phrae ,north,0.1364,9646,62210,62067,143,126370000,126110000,260000
2021-04-01,Lampang ,north,0.1509,12076,88127,87577,550,251060000,249020000,2040000
2021-04-01,Lamphun ,north,0.1056,4092,70522,70337,185,87700000,87400000,300000
2021-04-01,Mae Hong Son ,north,0.0934,7603,42084,41573,511,144760000,142170000,2590000
2021-04-01,Uttaradit ,north,0.1352,14132,47493,47493,0,69110000,69110000,0
2021-04-01,Uthai Thani ,north,0.09480000000000001,4869,61633,61633,0,95560000,95560000,0
2021-04-01,Sukhothai ,north,0.12539999999999998,14489,56642,55966,676,132680000,131050000,1630000
2021-04-01,Nan ,north,0.1206,13549,60575,60465,110,127860000,127370000,490000
2021-04-01,Kalasin ,east_northeast,0.0929,4172,12687,12687,0,16050000,16050000,0
2021-04-01,Khon Kaen ,east_northeast,0.1085,31782,57354,57291,63,114460000,114220000,240000
2021-04-01,Chaiyaphum ,east_northeast,0.1656,26881,40561,40512,49,63890000,63790000,100000
2021-04-01,Nakhon Phanom ,east_northeast,0.1501,9678,27584,27557,27,41030000,40990000,40000
2021-04-01,Nakhon Ratchasima ,east_northeast,0.2736,192003,314682,313761,921,593280000,591000000,2280000
2021-04-01,Buriram ,east_northeast,0.10369999999999999,17364,38966,38860,106,76720000,76520000,200000
2021-04-01,Maha Sarakham ,east_northeast,0.08259999999999999,6509,12276,12276,0,17610000,17610000,0
2021-04-01,Mukdahan ,east_northeast,0.1027,7922,29874,29874,0,44280000,44280000,0
2021-04-01,Roi Et ,east_northeast,0.10099999999999999,7673,9529,9529,0,14920000,14920000,0
2021-04-01,Loei ,east_northeast,0.0536,11290,50148,50126,22,69570000,69490000,80000
2021-04-01,Sisaket ,south,0.0967,5576,15523,15523,0,20500000,20500000,0
2021-04-01,Surin ,east_northeast,0.1233,18230,24004,23993,11,49680000,49660000,20000
2021-04-01,Nong Khai ,east_northeast,0.0622,8934,20943,20864,79,32770000,32660000,110000
2021-04-01,Bueng Kan ,east_northeast,0.04190000000000001,2157,5420,5420,0,7000000,7000000,0
2021-04-01,Udon Thani ,east_northeast,0.0689,16592,39172,39152,20,98740000,98680000,60000
2021-04-01,Ubon Ratchathani ,east_northeast,0.2633,54768,115331,115317,14,195240000,195210000,30000
2021-04-01,Sakon Nakhon ,east_northeast,0.1495,16069,27390,27375,15,46510000,46490000,20000
2021-04-01,Yasothon ,east_northeast,0.1452,8228,23761,23761,0,26900000,26900000,0
2021-04-01,Amnat Charoen ,east_northeast,0.1558,2653,7354,7354,0,10990000,10990000,0
2021-04-01,Nong Bua Lamphu ,east_northeast,0.053099999999999994,1686,4947,4947,0,4040000,4040000,0
2021-05-01,Bangkok,central,0.0942,251987,353401,323907,29494,1491530000,1068550000,422980000
2021-05-01,Lopburi ,central,0.046799999999999994,3023,10549,10510,39,10590000,10540000,50000
2021-05-01,Phra Nakhon Si Ayutthaya ,central,0.0634,9303,61595,61233,362,90610000,89970000,640000
2021-05-01,Saraburi ,central,0.056600000000000004,4725,17834,17781,53,21880000,21820000,60000
2021-05-01,Chainat ,central,0.0381,1285,5843,5843,0,5780000,5780000,0
2021-05-01,Nakhon Pathom ,central,0.0217,3598,13279,13263,16,14950000,14930000,20000
2021-05-01,Sing Buri ,central,0.036699999999999997,1036,3742,3742,0,4950000,4950000,0
2021-05-01,Ang Thong ,central,0.0452,895,2679,2679,0,2180000,2180000,0
2021-05-01,Nonthaburi ,central,0.0118,1095,3634,3613,21,4244700,4230000,14700
2021-05-01,Pathum Thani ,central,0.0225,1531,2265,2237,28,4020000,3990000,30000
2021-05-01,Samut Prakan ,central,0.0108,1827,3744,3666,78,5540000,5470000,70000
2021-05-01,Samut Sakhon ,central,0.0225,1250,1725,1725,0,1930000,1930000,0
2021-05-01,Chachoengsao ,east,0.015700000000000002,847,5688,5688,0,6020000,6020000,0
2021-05-01,Ratchaburi ,central,0.0256,3901,7378,7378,0,9230000,9230000,0
2021-05-01,Kanchanaburi ,central,0.049100000000000005,19921,38060,37817,243,84880000,84360000,520000
2021-05-01,Samut Songkhram ,central,0.0564,7705,13850,13794,56,16240000,16090000,150000
2021-05-01,Suphan Buri ,central,0.0255,3695,12597,12597,0,15150000,15150000,0
2021-05-01,Phetchaburi ,central,0.0723,35478,48502,48311,191,133000000,131960000,1040000
2021-05-01,Prachuap Khiri Khan ,central,0.0689,42558,51821,51734,87,203720000,202550000,1170000
2021-05-01,Chonburi ,east,0.019299999999999998,27145,29860,29153,707,145800000,140780000,5020000
2021-05-01,Chanthaburi ,east,0.0922,20737,22331,22275,56,60560000,60450000,110000
2021-05-01,Trat ,east,0.0766,22835,25099,24970,129,120070000,118300000,1770000
2021-05-01,Nakhon Nayok ,east,0.08449999999999999,5750,7533,7533,0,11940000,11940000,0
2021-05-01,Prachinburi ,east,0.045700000000000005,4292,5966,5966,0,11300000,11300000,0
2021-05-01,Rayong ,east,0.0789,18611,22710,22497,213,75560000,74840000,720000
2021-05-01,Sa Kaeo ,east,0.0346,2546,3712,3712,0,9200000,9200000,0
2021-05-01,Phuket ,south,0.0042,4061,5291,4766,525,54750000,43610000,11140000
2021-05-01,Phatthalung ,south,0.0163,953,1911,1911,0,2570000,2570000,0
2021-05-01,Trang ,south,0.0129,961,1786,1786,0,8540000,8540000,0
2021-05-01,Ranong ,south,0.011399999999999999,1137,1678,1678,0,4590000,4590000,0
2021-05-01,Chumphon ,south,0.016200000000000003,923,1501,1501,0,4930000,4930000,0
2021-05-01,Pattani ,south,0.0268,876,1288,1288,0,3330000,3330000,0
2021-05-01,Yala ,south,0.0326,1546,2178,2178,0,4950000,4950000,0
2021-05-01,Nakhon Si Thammarat ,south,0.0576,5781,7956,7956,0,25020000,25020000,0
2021-05-01,Narathiwat ,south,0.0219,742,1063,1063,0,2420000,2420000,0
2021-05-01,Krabi ,south,0.0038,941,2222,2082,140,22310000,21210000,1100000
2021-05-01,Songkhla ,south,0.0125,1923,2754,2723,31,15420000,15230000,190000
2021-05-01,Phang Nga ,south,0.027999999999999997,6247,8721,8100,621,37400000,31400000,6000000
2021-05-01,Surat Thani ,south,0.013000000000000001,1607,3429,3408,21,20410000,20180000,230000
2021-05-01,Satun ,south,0.0653,3674,5525,5489,36,25620000,25480000,140000
2021-05-01,Kamphaeng Phet ,north,0.0718,6106,8775,8775,0,9480000,9480000,0
2021-05-01,Chiang Rai ,north,0.0783,30099,33777,33431,346,148470000,146720000,1750000
2021-05-01,Chiang Mai ,north,0.07519999999999999,70959,97868,95795,2073,532290000,520810000,11480000
2021-05-01,Phichit ,north,0.0547,3789,7231,7231,0,10030000,10030000,0
2021-05-01,Nakhon Sawan ,north,0.1073,15393,21893,21893,0,41280000,41280000,0
2021-05-01,Tak ,north,0.0736,13706,19138,19115,23,42790000,42740000,50000
2021-05-01,Phitsanulok ,north,0.1051,23433,30519,30433,86,68680000,68520000,160000
2021-05-01,Phayao ,north,0.1065,5168,11143,11122,21,19460000,19420000,40000
2021-05-01,Phetchabun ,north,0.0924,27136,30774,30774,0,74680000,74680000,0
2021-05-01,Phrae ,north,0.0757,5296,7717,7717,0,12700000,12700000,0
2021-05-01,Lampang ,north,0.0864,6855,9481,9078,403,22450000,21440000,1010000
2021-05-01,Lamphun ,north,0.0519,1996,8607,8482,125,8390000,8230000,160000
2021-05-01,Mae Hong Son ,north,0.0623,12078,13138,12870,268,34490000,33630000,860000
2021-05-01,Uttaradit ,north,0.058600000000000006,5716,8216,8216,0,7700000,7700000,0
2021-05-01,Uthai Thani ,north,0.0236,1167,2668,2668,0,2790000,2790000,0
2021-05-01,Sukhothai ,north,0.0248,2834,4869,4747,122,7620000,7390000,230000
2021-05-01,Nan ,north,0.053399999999999996,5641,6955,6876,79,10930000,10770000,160000
2021-05-01,Kalasin ,east_northeast,0.0176,824,2258,2258,0,1850000,1850000,0
2021-05-01,Khon Kaen ,east_northeast,0.050499999999999996,15252,46729,46690,39,78610000,78510000,100000
2021-05-01,Chaiyaphum ,east_northeast,0.037000000000000005,5794,7737,7725,12,9720000,9700000,20000
2021-05-01,Nakhon Phanom ,east_northeast,0.0206,1396,4972,4963,9,5680000,5660000,20000
2021-05-01,Nakhon Ratchasima ,east_northeast,0.0806,58023,95155,94599,556,149990000,148790000,1200000
2021-05-01,Buriram ,east_northeast,0.0645,11108,19949,19899,50,30050000,29970000,80000
2021-05-01,Maha Sarakham ,east_northeast,0.0277,2302,4341,4341,0,4650000,4650000,0
2021-05-01,Mukdahan ,east_northeast,0.0226,1799,6784,6784,0,7880000,7880000,0
2021-05-01,Roi Et ,east_northeast,0.0301,2409,6265,6265,0,5980000,5980000,0
2021-05-01,Loei ,east_northeast,0.0151,3286,6303,6296,7,7970000,7950000,20000
2021-05-01,Sisaket ,south,0.020099999999999996,1235,3439,3439,0,3440000,3440000,0
2021-05-01,Surin ,east_northeast,0.0435,6689,8806,8806,0,11570000,11570000,0
2021-05-01,Nong Khai ,east_northeast,0.0433,6310,13264,13246,18,16310000,16280000,30000
2021-05-01,Bueng Kan ,east_northeast,0.0115,609,2107,2107,0,2240000,2240000,0
2021-05-01,Udon Thani ,east_northeast,0.0208,5145,11676,11669,7,22360000,22340000,20000
2021-05-01,Ubon Ratchathani ,east_northeast,0.030699999999999998,6702,17785,17785,0,22870000,22870000,0
2021-05-01,Sakon Nakhon ,east_northeast,0.0173,1921,3867,3867,0,4570000,4570000,0
2021-05-01,Yasothon ,east_northeast,0.016200000000000003,310,952,952,0,870000,870000,0
2021-05-01,Amnat Charoen ,east_northeast,0.0159,280,1140,1140,0,1360000,1360000,0
2021-05-01,Nong Bua Lamphu ,east_northeast,0.0226,745,2186,2186,0,1430000,1430000,0
2021-06-01,Bangkok,central,0.0925,222436,256622,230749,25873,1093880000,743110000,350770000
2021-06-01,Lopburi ,central,0.045,2747,8701,8660,41,8440000,8390000,50000
2021-06-01,Phra Nakhon Si Ayutthaya ,central,0.0689,9045,61845,61474,371,90400000,89780000,620000
2021-06-01,Saraburi ,central,0.0718,4536,14753,14707,46,17990000,17940000,50000
2021-06-01,Chainat ,central,0.0323,1046,5221,5221,0,5100000,5100000,0
2021-06-01,Nakhon Pathom ,central,0.0203,3186,8757,8744,13,9590000,9570000,20000
2021-06-01,Sing Buri ,central,0.0416,1128,3421,3421,0,4440000,4440000,0
2021-06-01,Ang Thong ,central,0.042699999999999995,843,2258,2258,0,1800000,1800000,0
2021-06-01,Nonthaburi ,central,0.0105,882,2979,2961,18,3470000,3450000,20000
2021-06-01,Pathum Thani ,central,0.0158,1044,1664,1645,19,2840000,2820000,20000
2021-06-01,Samut Prakan ,central,0.009300000000000001,1485,2956,2895,61,4290000,4240000,50000
2021-06-01,Samut Sakhon ,central,0.019799999999999998,1059,1347,1347,0,1500000,1500000,0
2021-06-01,Chachoengsao ,east,0.0148,737,4415,4415,0,4530000,4530000,0
2021-06-01,Ratchaburi ,central,0.0496,7465,13639,13639,0,16440000,16440000,0
2021-06-01,Kanchanaburi ,central,0.0766,31105,61297,61077,220,132800000,132330000,470000
2021-06-01,Samut Songkhram ,central,0.0667,9087,17315,17259,56,20050000,19900000,150000
2021-06-01,Suphan Buri ,central,0.047,6999,20061,20061,0,23470000,23470000,0
2021-06-01,Phetchaburi ,central,0.0674,33022,41434,41240,194,109660000,108440000,1220000
2021-06-01,Prachuap Khiri Khan ,central,0.0548,34465,36899,36826,73,138700000,137900000,800000
2021-06-01,Chonburi ,east,0.0204,27798,41441,40719,722,188110000,182910000,5200000
2021-06-01,Chanthaburi ,east,0.0859,19840,20687,20602,85,53810000,53630000,180000
2021-06-01,Trat ,east,0.0604,17408,19181,19065,116,87570000,86040000,1530000
2021-06-01,Nakhon Nayok ,east,0.0638,4230,4620,4620,0,7180000,7180000,0
2021-06-01,Prachinburi ,east,0.0297,2547,3921,3921,0,7210000,7210000,0
2021-06-01,Rayong ,east,0.0816,18997,23374,23094,280,79760000,78920000,840000
2021-06-01,Sa Kaeo ,east,0.0285,2037,2761,2761,0,6530000,6530000,0
2021-06-01,Phuket ,south,0.019299999999999998,16628,28777,28224,553,253970000,243120000,10850000
2021-06-01,Phatthalung ,south,0.0285,1605,2836,2836,0,3540000,3540000,0
2021-06-01,Trang ,south,0.0255,1811,3134,3134,0,14350000,14350000,0
2021-06-01,Ranong ,south,0.0155,1491,2092,2092,0,5310000,5310000,0
2021-06-01,Chumphon ,south,0.030699999999999998,1684,2539,2539,0,8030000,8030000,0
2021-06-01,Pattani ,south,0.0184,583,837,837,0,2000000,2000000,0
2021-06-01,Yala ,south,0.015300000000000001,692,923,923,0,1910000,1910000,0
2021-06-01,Nakhon Si Thammarat ,south,0.0733,7152,9919,9919,0,29400000,29400000,0
2021-06-01,Narathiwat ,south,0.0132,433,613,613,0,1260000,1260000,0
2021-06-01,Krabi ,south,0.0048,1093,2661,2547,114,25060000,24230000,830000
2021-06-01,Songkhla ,south,0.0105,1539,2071,2048,23,10740000,10610000,130000
2021-06-01,Phang Nga ,south,0.0203,4474,5909,5544,365,22810000,19570000,3240000
2021-06-01,Surat Thani ,south,0.0179,2236,4456,4439,17,24890000,24720000,170000
2021-06-01,Satun ,south,0.0365,2001,3087,3058,29,13370000,13260000,110000
2021-06-01,Kamphaeng Phet ,north,0.0632,5018,7265,7265,0,6600000,6600000,0
2021-06-01,Chiang Rai ,north,0.0658,22962,26342,26054,288,112040000,110630000,1410000
2021-06-01,Chiang Mai ,north,0.0687,59083,80431,79438,993,414730000,409430000,5300000
2021-06-01,Phichit ,north,0.047599999999999996,3138,6377,6377,0,7800000,7800000,0
2021-06-01,Nakhon Sawan ,north,0.0821,11394,18315,18315,0,30300000,30300000,0
2021-06-01,Tak ,north,0.06849999999999999,11809,16539,16539,0,33590000,33590000,0
2021-06-01,Phitsanulok ,north,0.0934,20540,28588,28523,65,55730000,55610000,120000
2021-06-01,Phayao ,north,0.08460000000000001,3963,8699,8699,0,13710000,13710000,0
2021-06-01,Phetchabun ,north,0.078,20779,23760,23760,0,52240000,52240000,0
2021-06-01,Phrae ,north,0.0641,4158,6005,6005,0,8600000,8600000,0
2021-06-01,Lampang ,north,0.06280000000000001,4727,6899,6564,335,15180000,14370000,810000
2021-06-01,Lamphun ,north,0.045599999999999995,1649,7266,7171,95,6680000,6570000,110000
2021-06-01,Mae Hong Son ,north,0.0429,7872,8603,8391,212,21120000,20480000,640000
2021-06-01,Uttaradit ,north,0.0528,4901,7129,7129,0,6270000,6270000,0
2021-06-01,Uthai Thani ,north,0.0349,1609,2979,2979,0,2920000,2920000,0
2021-06-01,Sukhothai ,north,0.030600000000000002,2988,7337,7029,308,10810000,10260000,550000
2021-06-01,Nan ,north,0.1074,10427,12538,12477,61,18650000,18530000,120000
2021-06-01,Kalasin ,east_northeast,0.0225,1019,2792,2792,0,2140000,2140000,0
2021-06-01,Khon Kaen ,east_northeast,0.048799999999999996,13888,39567,39567,0,65590000,65590000,0
2021-06-01,Chaiyaphum ,east_northeast,0.0308,4651,6515,6506,9,7990000,7970000,20000
2021-06-01,Nakhon Phanom ,east_northeast,0.023799999999999998,1538,5327,5318,9,5950000,5940000,10000
2021-06-01,Nakhon Ratchasima ,east_northeast,0.11720000000000001,73450,120449,119801,648,189820000,188420000,1400000
2021-06-01,Buriram ,east_northeast,0.0765,12817,23788,23726,62,35160000,35070000,90000
2021-06-01,Maha Sarakham ,east_northeast,0.0235,1883,3552,3552,0,3760000,3760000,0
2021-06-01,Mukdahan ,east_northeast,0.023700000000000002,1734,6539,6539,0,7240000,7240000,0
2021-06-01,Roi Et ,east_northeast,0.0195,1500,3901,3901,0,3720000,3720000,0
2021-06-01,Loei ,east_northeast,0.0126,2661,5204,5185,19,6540000,6500000,40000
2021-06-01,Sisaket ,south,0.042699999999999995,2469,4874,4874,0,4790000,4790000,0
2021-06-01,Surin ,east_northeast,0.0553,8269,10395,10377,18,13040000,13010000,30000
2021-06-01,Nong Khai ,east_northeast,0.0421,6065,12678,12669,9,15170000,15150000,20000
2021-06-01,Bueng Kan ,east_northeast,0.0264,1364,3482,3477,5,3660000,3650000,10000
2021-06-01,Udon Thani ,east_northeast,0.0382,7754,16592,16582,10,31070000,31040000,30000
2021-06-01,Ubon Ratchathani ,east_northeast,0.0414,8541,19665,19665,0,24640000,24640000,0
2021-06-01,Sakon Nakhon ,east_northeast,0.0256,2753,5542,5542,0,6480000,6480000,0
2021-06-01,Yasothon ,east_northeast,0.0285,531,1630,1630,0,1460000,1460000,0
2021-06-01,Amnat Charoen ,east_northeast,0.0323,549,2235,2235,0,2650000,2650000,0
2021-06-01,Nong Bua Lamphu ,east_northeast,0.0348,1107,3248,3248,0,2100000,2100000,0
2021-07-01,Bangkok,central,0.0454,104844,169121,147154,21967,709260000,429870000,279390000
2021-07-01,Lopburi ,central,0.0393,2115,5956,5927,29,5430000,5400000,30000
2021-07-01,Phra Nakhon Si Ayutthaya ,central,0.0487,6207,21529,21302,227,29320000,28980000,340000
2021-07-01,Saraburi ,central,0.04190000000000001,2695,7419,7401,18,7430000,7410000,20000
2021-07-01,Chainat ,central,0.0273,730,3194,3194,0,2900000,2900000,0
2021-07-01,Nakhon Pathom ,central,0.0115,1281,4047,4047,0,4015750,4020000,-4250
2021-07-01,Sing Buri ,central,0.0331,757,2031,2031,0,2440000,2440000,0
2021-07-01,Ang Thong ,central,0.0246,482,1386,1386,0,1080000,1080000,0
2021-07-01,Nonthaburi ,central,0.0076,557,2156,2144,12,2300000,2290000,10000
2021-07-01,Pathum Thani ,central,0.012,672,1116,1103,13,1060000,1050000,10000
2021-07-01,Samut Prakan ,central,0.0037,618,1526,1481,45,1850000,1820000,30000
2021-07-01,Samut Sakhon ,central,0.0123,528,861,861,0,820000,820000,0
2021-07-01,Chachoengsao ,east,0.0087,440,2359,2359,0,2240000,2240000,0
2021-07-01,Ratchaburi ,central,0.0241,3780,10667,10667,0,12500000,12500000,0
2021-07-01,Kanchanaburi ,central,0.0311,12667,26909,26862,47,52240000,52140000,100000
2021-07-01,Samut Songkhram ,central,0.0194,2648,6501,6501,0,7380000,7380000,0
2021-07-01,Suphan Buri ,central,0.019,2776,9449,9449,0,9950000,9950000,0
2021-07-01,Phetchaburi ,central,0.0252,12527,15182,15093,89,34930000,34380000,550000
2021-07-01,Prachuap Khiri Khan ,central,0.0291,18263,19918,19850,68,69740000,69010000,730000
2021-07-01,Chonburi ,east,0.0115,15362,34619,34021,598,143840000,139570000,4270000
2021-07-01,Chanthaburi ,east,0.0713,16972,17139,17083,56,43690000,43570000,120000
2021-07-01,Trat ,east,0.041299999999999996,12286,17144,17038,106,73270000,72070000,1200000
2021-07-01,Nakhon Nayok ,east,0.031400000000000004,2116,3515,3515,0,5250000,5250000,0
2021-07-01,Prachinburi ,east,0.018500000000000003,1678,3384,3384,0,5790000,5790000,0
2021-07-01,Rayong ,east,0.0691,16591,20171,19927,244,63120000,62380000,740000
2021-07-01,Sa Kaeo ,east,0.0178,1313,2531,2531,0,5370000,5370000,0
2021-07-01,Phuket ,south,0.0239,21398,36699,20738,15961,1108710000,169250000,939460000
2021-07-01,Phatthalung ,south,0.0227,1330,1934,1934,0,2290000,2290000,0
2021-07-01,Trang ,south,0.0213,1565,2288,2288,0,9530000,9530000,0
2021-07-01,Ranong ,south,0.0128,1270,1633,1633,0,3820000,3820000,0
2021-07-01,Chumphon ,south,0.0254,1436,1865,1865,0,5520000,5520000,0
2021-07-01,Pattani ,south,0.014199999999999999,464,585,585,0,1310000,1310000,0
2021-07-01,Yala ,south,0.0097,441,529,529,0,1000000,1000000,0
2021-07-01,Nakhon Si Thammarat ,south,0.0613,6230,8425,8425,0,21360000,21360000,0
2021-07-01,Narathiwat ,south,0.011200000000000002,377,474,474,0,900000,900000,0
2021-07-01,Krabi ,south,0.0034999999999999996,835,1716,1716,0,14970000,14970000,0
2021-07-01,Songkhla ,south,0.0058,901,1474,1474,0,7090000,7090000,0
2021-07-01,Phang Nga ,south,0.018500000000000003,4206,5208,4622,586,20560000,15580000,4980000
2021-07-01,Surat Thani ,south,0.0159,2082,3602,3188,414,20570000,16620000,3950000
2021-07-01,Satun ,south,0.0236,1345,1839,1820,19,5880000,5810000,70000
2021-07-01,Kamphaeng Phet ,north,0.0583,4586,6317,6317,0,5110000,5110000,0
2021-07-01,Chiang Rai ,north,0.0676,23836,25803,25572,231,105060000,103990000,1070000
2021-07-01,Chiang Mai ,north,0.0604,52843,69510,68521,989,354810000,349590000,5220000
2021-07-01,Phichit ,north,0.045,3067,6355,6355,0,6730000,6730000,0
2021-07-01,Nakhon Sawan ,north,0.0693,9801,14969,14969,0,23290000,23290000,0
2021-07-01,Tak ,north,0.061399999999999996,10955,13933,13933,0,26020000,26020000,0
2021-07-01,Phitsanulok ,north,0.08259999999999999,18673,26075,25939,136,43890000,43650000,240000
2021-07-01,Phayao ,north,0.0785,3818,8278,8278,0,11630000,11630000,0
2021-07-01,Phetchabun ,north,0.0706,19417,22759,22735,24,44050000,43990000,60000
2021-07-01,Phrae ,north,0.069,4605,5424,5424,0,6640000,6640000,0
2021-07-01,Lampang ,north,0.0521,4034,6122,5950,172,12500000,12110000,390000
2021-07-01,Lamphun ,north,0.0387,1452,6810,6725,85,5540000,5450000,90000
2021-07-01,Mae Hong Son ,north,0.0464,8841,9411,9186,225,22040000,21380000,660000
2021-07-01,Uttaradit ,north,0.0493,4704,5713,5713,0,4710000,4710000,0
2021-07-01,Uthai Thani ,north,0.0236,1140,2109,2109,0,1990000,1990000,0
2021-07-01,Sukhothai ,north,0.0265,2682,5178,5003,175,7390000,7090000,300000
2021-07-01,Nan ,north,0.0748,7436,9841,9805,36,14060000,13990000,70000
2021-07-01,Kalasin ,east_northeast,0.019,895,2495,2495,0,1790000,1790000,0
2021-07-01,Khon Kaen ,east_northeast,0.044000000000000004,12918,17954,17954,0,20720000,20720000,0
2021-07-01,Chaiyaphum ,east_northeast,0.0208,3225,6802,6802,0,7660000,7660000,0
2021-07-01,Nakhon Phanom ,east_northeast,0.0215,1432,4473,4473,0,4630000,4630000,0
2021-07-01,Nakhon Ratchasima ,east_northeast,0.0746,47868,83136,82593,543,100110000,99110000,1000000
2021-07-01,Buriram ,east_northeast,0.0529,9185,10752,10721,31,13810000,13770000,40000
2021-07-01,Maha Sarakham ,east_northeast,0.019299999999999998,1595,2664,2664,0,2130000,2130000,0
2021-07-01,Mukdahan ,east_northeast,0.0204,1538,5772,5772,0,6250000,6250000,0
2021-07-01,Roi Et ,east_northeast,0.0174,1379,2573,2573,0,1550000,1550000,0
2021-07-01,Loei ,east_northeast,0.0111,2431,4573,4565,8,3520000,3510000,10000
2021-07-01,Sisaket ,south,0.024399999999999998,1488,3604,3604,0,2310000,2310000,0
2021-07-01,Surin ,east_northeast,0.0381,5703,7265,7252,13,6830000,6820000,10000
2021-07-01,Nong Khai ,east_northeast,0.0377,5620,8319,8316,3,5610000,5600000,10000
2021-07-01,Bueng Kan ,east_northeast,0.0195,1038,2816,2816,0,2720000,2720000,0
2021-07-01,Udon Thani ,east_northeast,0.0288,6097,10132,10127,5,15270000,15260000,10000
2021-07-01,Ubon Ratchathani ,east_northeast,0.0253,5401,6431,6431,0,7190000,7190000,0
2021-07-01,Sakon Nakhon ,east_northeast,0.022000000000000002,2440,4796,4796,0,3460000,3460000,0
2021-07-01,Yasothon ,east_northeast,0.0231,445,1497,1497,0,950000,950000,0
2021-07-01,Amnat Charoen ,east_northeast,0.0263,464,1392,1392,0,1010000,1010000,0
2021-07-01,Nong Bua Lamphu ,east_northeast,0.0273,899,2269,2269,0,1090000,1090000,0
2021-08-01,Bangkok,central,0.049100000000000005,114961,202959,181431,21528,790360000,519840000,270520000
2021-08-01,Lopburi ,central,0.0521,2801,7057,7028,29,6300000,6270000,30000
2021-08-01,Phra Nakhon Si Ayutthaya ,central,0.0398,5131,17000,16958,42,22600000,22540000,60000
2021-08-01,Saraburi ,central,0.062400000000000004,4066,9794,9776,18,9530000,9510000,20000
2021-08-01,Chainat ,central,0.047599999999999996,1349,4171,4171,0,3610000,3610000,0
2021-08-01,Nakhon Pathom ,central,0.0076,859,2714,2714,0,2625750,2630000,-4250
2021-08-01,Sing Buri ,central,0.047,1099,3064,3064,0,3580000,3580000,0
2021-08-01,Ang Thong ,central,0.0143,286,962,962,0,730000,730000,0
2021-08-01,Nonthaburi ,central,0.011000000000000001,839,2822,2815,7,3010000,3000000,10000
2021-08-01,Pathum Thani ,central,0.013500000000000002,752,1319,1306,13,1150000,1140000,10000
2021-08-01,Samut Prakan ,central,0.0049,812,1887,1860,27,2250000,2230000,20000
2021-08-01,Samut Sakhon ,central,0.0195,972,1338,1338,0,1270000,1270000,0
2021-08-01,Chachoengsao ,east,0.0064,307,1995,1995,0,1860000,1860000,0
2021-08-01,Ratchaburi ,central,0.015600000000000001,2360,7187,7187,0,8170000,8170000,0
2021-08-01,Kanchanaburi ,central,0.0182,7400,20185,20157,28,36000000,35940000,60000
2021-08-01,Samut Songkhram ,central,0.010700000000000001,1464,4546,4546,0,4800000,4800000,0
2021-08-01,Suphan Buri ,central,0.0129,1922,6542,6542,0,6630000,6630000,0
2021-08-01,Phetchaburi ,central,0.0215,10658,12139,12096,43,26590000,26330000,260000
2021-08-01,Prachuap Khiri Khan ,central,0.0202,12616,13974,13921,53,47060000,46500000,560000
2021-08-01,Chonburi ,east,0.0098,13288,30270,29695,575,119980000,116020000,3960000
2021-08-01,Chanthaburi ,east,0.1081,18148,17881,17815,66,49440000,49290000,150000
2021-08-01,Trat ,east,0.0617,20675,22368,22277,91,94950000,93920000,1030000
2021-08-01,Nakhon Nayok ,east,0.0264,1793,2679,2679,0,3870000,3870000,0
2021-08-01,Prachinburi ,east,0.0165,1521,3143,3143,0,5270000,5270000,0
2021-08-01,Rayong ,east,0.0594,14247,18635,18409,226,55780000,55120000,660000
2021-08-01,Sa Kaeo ,east,0.0168,1240,2377,2377,0,4880000,4880000,0
2021-08-01,Phuket ,south,0.0218,19579,33530,18204,15326,1038990000,141800000,897190000
2021-08-01,Phatthalung ,south,0.0196,1154,1598,1598,0,1790000,1790000,0
2021-08-01,Trang ,south,0.0217,1592,2469,2469,0,9810000,9810000,0
2021-08-01,Ranong ,south,0.0113,1126,1369,1369,0,2970000,2970000,0
2021-08-01,Chumphon ,south,0.0232,1312,1644,1644,0,4600000,4600000,0
2021-08-01,Pattani ,south,0.0131,426,517,517,0,1080000,1080000,0
2021-08-01,Yala ,south,0.008199999999999999,373,438,438,0,760000,760000,0
2021-08-01,Nakhon Si Thammarat ,south,0.059500000000000004,6043,7996,7996,0,19280000,19280000,0
2021-08-01,Narathiwat ,south,0.0103,348,421,421,0,740000,740000,0
2021-08-01,Krabi ,south,0.0046,1079,2096,1981,115,16970000,16370000,600000
2021-08-01,Songkhla ,south,0.004699999999999999,729,1132,1132,0,5100000,5100000,0
2021-08-01,Phang Nga ,south,0.0239,5333,7037,5969,1068,28000000,19250000,8750000
2021-08-01,Surat Thani ,south,0.0227,2903,4790,4115,675,26590000,20220000,6370000
2021-08-01,Satun ,south,0.0174,994,1183,1170,13,3550000,3500000,50000
2021-08-01,Kamphaeng Phet ,north,0.0617,4834,6769,6769,0,5610000,5610000,0
2021-08-01,Chiang Rai ,north,0.0724,25780,28142,27897,245,114150000,113010000,1140000
2021-08-01,Chiang Mai ,north,0.0596,52380,68614,67650,964,347350000,342220000,5130000
2021-08-01,Phichit ,north,0.0487,3347,6914,6914,0,7450000,7450000,0
2021-08-01,Nakhon Sawan ,north,0.0712,10309,15946,15946,0,24650000,24650000,0
2021-08-01,Tak ,north,0.0524,9451,12606,12606,0,22860000,22860000,0
2021-08-01,Phitsanulok ,north,0.0789,18020,25715,25564,151,42840000,42570000,270000
2021-08-01,Phayao ,north,0.0834,4189,9277,9277,0,13290000,13290000,0
2021-08-01,Phetchabun ,north,0.057999999999999996,16366,20292,20262,30,38760000,38680000,80000
2021-08-01,Phrae ,north,0.07919999999999999,5383,5872,5872,0,7160000,7160000,0
2021-08-01,Lampang ,north,0.06559999999999999,5091,6862,6727,135,13820000,13520000,300000
2021-08-01,Lamphun ,north,0.0574,2196,7455,7381,74,6020000,5940000,80000
2021-08-01,Mae Hong Son ,north,0.0425,8235,8861,8659,202,20400000,19810000,590000
2021-08-01,Uttaradit ,north,0.0437,4309,6329,6329,0,5080000,5080000,0
2021-08-01,Uthai Thani ,north,0.029300000000000003,1435,2279,2279,0,2190000,2190000,0
2021-08-01,Sukhothai ,north,0.0206,2119,4868,4868,0,6670000,6670000,0
2021-08-01,Nan ,north,0.0819,8298,9832,9798,34,14350000,14280000,70000
2021-08-01,Kalasin ,east_northeast,0.0173,808,2306,2306,0,1650000,1650000,0
2021-08-01,Khon Kaen ,east_northeast,0.0454,13007,21098,21098,0,25540000,25540000,0
2021-08-01,Chaiyaphum ,east_northeast,0.0218,3384,13695,13682,13,17590000,17570000,20000
2021-08-01,Nakhon Phanom ,east_northeast,0.0192,1275,3548,3548,0,3730000,3730000,0
2021-08-01,Nakhon Ratchasima ,east_northeast,0.0794,50973,88532,87939,593,108730000,107610000,1120000
2021-08-01,Buriram ,east_northeast,0.0567,9847,12087,12044,43,15840000,15790000,50000
2021-08-01,Maha Sarakham ,east_northeast,0.020099999999999996,1660,2772,2772,0,2240000,2240000,0
2021-08-01,Mukdahan ,east_northeast,0.018799999999999997,1418,5322,5322,0,5760000,5760000,0
2021-08-01,Roi Et ,east_northeast,0.0182,1447,2700,2700,0,1630000,1630000,0
2021-08-01,Loei ,east_northeast,0.013600000000000001,2613,5789,5778,11,4480000,4460000,20000
2021-08-01,Sisaket ,south,0.0253,1550,3838,3838,0,2520000,2520000,0
2021-08-01,Surin ,east_northeast,0.039,5829,8153,8131,22,7370000,7350000,20000
2021-08-01,Nong Khai ,east_northeast,0.0298,4591,6520,6513,7,4440000,4430000,10000
2021-08-01,Bueng Kan ,east_northeast,0.017,911,2114,2114,0,2020000,2020000,0
2021-08-01,Udon Thani ,east_northeast,0.0268,5635,9291,9282,9,14170000,14150000,20000
2021-08-01,Ubon Ratchathani ,east_northeast,0.026600000000000002,5699,7252,7252,0,8370000,8370000,0
2021-08-01,Sakon Nakhon ,east_northeast,0.0216,2389,4675,4675,0,3380000,3380000,0
2021-08-01,Yasothon ,east_northeast,0.024,464,1561,1561,0,1000000,1000000,0
2021-08-01,Amnat Charoen ,east_northeast,0.027200000000000002,480,1440,1440,0,1050000,1050000,0
2021-08-01,Nong Bua Lamphu ,east_northeast,0.0179,589,1487,1487,0,720000,720000,0
2021-09-01,Bangkok,central,0.141,230832,448391,422787,25604,1600530000,1275610000,324920000
2021-09-01,Lopburi ,central,0.0983,6965,24082,24044,38,22710000,22670000,40000
2021-09-01,Phra Nakhon Si Ayutthaya ,central,0.13449999999999998,16045,63382,63260,122,84530000,84350000,180000
2021-09-01,Saraburi ,central,0.1052,9130,30780,30737,43,28051000,28000000,51000
2021-09-01,Chainat ,central,0.09179999999999999,3743,11052,11052,0,9670000,9670000,0
2021-09-01,Nakhon Pathom ,central,0.0545,6032,17076,17058,18,17170000,17150000,20000
2021-09-01,Sing Buri ,central,0.0863,3316,9410,9410,0,11160000,11160000,0
2021-09-01,Ang Thong ,central,0.0737,1469,5978,5978,0,4630000,4630000,0
2021-09-01,Nonthaburi ,central,0.0645,4873,13326,13275,51,13005000,12930000,75000
2021-09-01,Pathum Thani ,central,0.06860000000000001,3990,10969,10893,76,10092000,10020000,72000
2021-09-01,Samut Prakan ,central,0.0383,4764,12413,12329,84,14980000,14910000,70000
2021-09-01,Samut Sakhon ,central,0.0443,2860,7943,7943,0,7000000,7000000,0
2021-09-01,Chachoengsao ,east,0.0471,2288,7480,7480,0,7260000,7260000,0
2021-09-01,Ratchaburi ,central,0.0737,11197,30897,30897,0,36120000,36120000,0
2021-09-01,Kanchanaburi ,central,0.1459,57564,190781,190728,53,308040000,307940000,100000
2021-09-01,Samut Songkhram ,central,0.09390000000000001,12397,31388,31388,0,36190000,36190000,0
2021-09-01,Suphan Buri ,central,0.062,8985,30584,30584,0,31600000,31600000,0
2021-09-01,Phetchaburi ,central,0.1063,50513,88893,88804,89,180110000,179600000,510000
2021-09-01,Prachuap Khiri Khan ,central,0.1032,60088,78909,78814,95,261980000,261010000,970000
2021-09-01,Chonburi ,east,0.122,93480,119870,119059,811,483640000,477990000,5650000
2021-09-01,Chanthaburi ,east,0.1705,20481,24937,24842,95,65390000,65170000,220000
2021-09-01,Trat ,east,0.0947,30630,33159,33006,153,145000000,143250000,1750000
2021-09-01,Nakhon Nayok ,east,0.0873,5440,6150,6150,0,9180000,9180000,0
2021-09-01,Prachinburi ,east,0.0683,6376,7010,7010,0,12260000,12260000,0
2021-09-01,Rayong ,east,0.1232,17275,24688,24442,246,68630000,67920000,710000
2021-09-01,Sa Kaeo ,east,0.0524,3685,4108,4108,0,8660000,8660000,0
2021-09-01,Phuket ,south,0.07690000000000001,63589,85481,60028,25453,1946280000,455040000,1491240000
2021-09-01,Phatthalung ,south,0.022400000000000003,1273,1958,1958,0,2240000,2240000,0
2021-09-01,Trang ,south,0.0525,3783,5191,5191,0,22300000,22300000,0
2021-09-01,Ranong ,south,0.0218,2095,2582,2582,0,5690000,5690000,0
2021-09-01,Chumphon ,south,0.0342,1871,2620,2620,0,7490000,7490000,0
2021-09-01,Pattani ,south,0.033,1051,1410,1410,0,3000000,3000000,0
2021-09-01,Yala ,south,0.011699999999999999,533,710,710,0,1220000,1220000,0
2021-09-01,Nakhon Si Thammarat ,south,0.0681,6758,9361,9361,0,22860000,22860000,0
2021-09-01,Narathiwat ,south,0.0209,687,945,945,0,1680000,1680000,0
2021-09-01,Krabi ,south,0.011699999999999999,2573,4086,3912,174,36890000,35980000,910000
2021-09-01,Songkhla ,south,0.0068000000000000005,1018,1827,1827,0,8260000,8260000,0
2021-09-01,Phang Nga ,south,0.041299999999999996,8503,11169,9671,1498,44470000,32130000,12340000
2021-09-01,Surat Thani ,south,0.023399999999999997,3159,4772,3619,1153,29230000,18290000,10940000
2021-09-01,Satun ,south,0.023700000000000002,1304,1995,1995,0,6090000,6090000,0
2021-09-01,Kamphaeng Phet ,north,0.0692,5604,7679,7679,0,6530000,6530000,0
2021-09-01,Chiang Rai ,north,0.13949999999999999,48199,52280,52001,279,213820000,212510000,1310000
2021-09-01,Chiang Mai ,north,0.15,125275,149552,148477,1075,777800000,772040000,5760000
2021-09-01,Phichit ,north,0.0429,2940,7058,7058,0,7730000,7730000,0
2021-09-01,Nakhon Sawan ,north,0.0843,12280,18756,18756,0,29750000,29750000,0
2021-09-01,Tak ,north,0.0796,14461,18741,18741,0,34670000,34670000,0
2021-09-01,Phitsanulok ,north,0.1073,23486,33623,33466,157,57300000,57010000,290000
2021-09-01,Phayao ,north,0.1161,5793,12520,12407,113,18200000,18080000,120000
2021-09-01,Phetchabun ,north,0.0836,22618,26514,26475,39,51640000,51530000,110000
2021-09-01,Phrae ,north,0.1407,9204,11993,11993,0,14990000,14990000,0
2021-09-01,Lampang ,north,0.0917,6883,9312,9210,102,18990000,18760000,230000
2021-09-01,Lamphun ,north,0.0765,2830,8920,8828,92,7460000,7380000,80000
2021-09-01,Mae Hong Son ,north,0.058899999999999994,11022,11764,11539,225,27600000,26940000,660000
2021-09-01,Uttaradit ,north,0.049400000000000006,4803,7108,7108,0,5880000,5880000,0
2021-09-01,Uthai Thani ,north,0.032799999999999996,1628,2630,2630,0,2570000,2570000,0
2021-09-01,Sukhothai ,north,0.0304,3029,6514,6514,0,9000000,9000000,0
2021-09-01,Nan ,north,0.19640000000000002,18260,21353,21281,72,31960000,31810000,150000
2021-09-01,Kalasin ,east_northeast,0.0242,1088,4757,4757,0,3490000,3490000,0
2021-09-01,Khon Kaen ,east_northeast,0.0812,22740,36884,36884,0,47340000,47340000,0
2021-09-01,Chaiyaphum ,east_northeast,0.031400000000000004,4684,16842,16813,29,12600000,12570000,30000
2021-09-01,Nakhon Phanom ,east_northeast,0.0655,4257,9839,9839,0,9120000,9120000,0
2021-09-01,Nakhon Ratchasima ,east_northeast,0.1467,91468,158830,157909,921,201230000,199460000,1770000
2021-09-01,Buriram ,east_northeast,0.0949,15873,22217,22141,76,30760000,30670000,90000
2021-09-01,Maha Sarakham ,east_northeast,0.0305,2447,4086,4086,0,3310000,3310000,0
2021-09-01,Mukdahan ,east_northeast,0.0633,4595,17246,17246,0,18670000,18670000,0
2021-09-01,Roi Et ,east_northeast,0.025699999999999997,1968,3672,3672,0,2340000,2340000,0
2021-09-01,Loei ,east_northeast,0.0329,6105,13785,13770,15,11380000,11350000,30000
2021-09-01,Sisaket ,south,0.0731,4359,15417,15417,0,10170000,10170000,0
2021-09-01,Surin ,east_northeast,0.044800000000000006,6667,9296,9269,27,8420000,8390000,30000
2021-09-01,Nong Khai ,east_northeast,0.0506,7439,11497,11490,7,7850000,7840000,10000
2021-09-01,Bueng Kan ,east_northeast,0.0241,1225,2662,2662,0,2600000,2600000,0
2021-09-01,Udon Thani ,east_northeast,0.0348,6913,11621,11611,10,17770000,17750000,20000
2021-09-01,Ubon Ratchathani ,east_northeast,0.0704,14667,25612,25612,0,29730000,29730000,0
2021-09-01,Sakon Nakhon ,east_northeast,0.0408,4387,10521,10521,0,7690000,7690000,0
2021-09-01,Yasothon ,east_northeast,0.0583,1107,3724,3724,0,2390000,2390000,0
2021-09-01,Amnat Charoen ,east_northeast,0.0579,988,2964,2964,0,2170000,2170000,0
2021-09-01,Nong Bua Lamphu ,east_northeast,0.0235,745,1880,1880,0,930000,930000,0
2021-10-01,Bangkok,central,0.1568,271942,535508,483200,52308,2161440000,1493630000,667810000
2021-10-01,Lopburi ,central,0.1685,12336,47834,47796,38,46530000,46490000,40000
2021-10-01,Phra Nakhon Si Ayutthaya ,central,0.23629999999999998,28760,161519,160956,563,230590000,229740000,850000
2021-10-01,Saraburi ,central,0.1856,16525,62770,62680,90,58931000,58830000,101000
2021-10-01,Chainat ,central,0.15789999999999998,6656,25249,25249,0,22280000,22280000,0
2021-10-01,Nakhon Pathom ,central,0.1681,13994,37242,37188,54,39630000,39530000,100000
2021-10-01,Sing Buri ,central,0.1444,5718,15147,15124,23,18660000,18660000,0
2021-10-01,Ang Thong ,central,0.1334,2732,15302,15302,0,12420000,12420000,0
2021-10-01,Nonthaburi ,central,0.1264,9899,32482,32370,112,34215000,34090000,125000
2021-10-01,Pathum Thani ,central,0.1458,9104,26324,26147,177,25512000,25330000,182000
2021-10-01,Samut Prakan ,central,0.0786,9872,30524,30346,178,38210000,38000000,210000
2021-10-01,Samut Sakhon ,central,0.1252,7612,20981,20981,0,19350000,19350000,0
2021-10-01,Chachoengsao ,east,0.1165,5667,192208,192208,0,201220000,201220000,0
2021-10-01,Ratchaburi ,central,0.2144,33133,88889,88772,117,107610000,107250000,360000
2021-10-01,Kanchanaburi ,central,0.3284,166596,467938,467816,122,758610000,758330000,280000
2021-10-01,Samut Songkhram ,central,0.13369999999999999,18232,44761,44761,0,48130000,48130000,0
2021-10-01,Suphan Buri ,central,0.2249,33111,112708,112708,0,117540000,117540000,0
2021-10-01,Phetchaburi ,central,0.2761,135873,301889,301778,111,644980000,644380000,600000
2021-10-01,Prachuap Khiri Khan ,central,0.26530000000000004,144930,262017,261857,160,824660000,823090000,1570000
2021-10-01,Chonburi ,east,0.2923,191611,224103,223216,887,936590000,930460000,6130000
2021-10-01,Chanthaburi ,east,0.3369,41667,49181,49069,112,133990000,133740000,250000
2021-10-01,Trat ,east,0.1613,47540,51815,51639,176,222680000,220790000,1890000
2021-10-01,Nakhon Nayok ,east,0.2443,16085,21362,21362,0,33730000,33730000,0
2021-10-01,Prachinburi ,east,0.1886,16421,17246,17246,0,31280000,31280000,0
2021-10-01,Rayong ,east,0.302,40963,51424,51159,265,145780000,145020000,760000
2021-10-01,Sa Kaeo ,east,0.161,9601,11217,10519,698,24750000,23610000,1140000
2021-10-01,Phuket ,south,0.0915,78742,91363,64142,27221,2091400000,492600000,1598800000
2021-10-01,Phatthalung ,south,0.0319,1844,3107,3107,0,3690000,3690000,0
2021-10-01,Trang ,south,0.0754,5601,7387,7387,0,30770000,30770000,0
2021-10-01,Ranong ,south,0.0431,4265,5367,5367,0,12040000,12040000,0
2021-10-01,Chumphon ,south,0.12480000000000001,6832,7560,7560,0,22200000,22200000,0
2021-10-01,Pattani ,south,0.0276,906,1157,1157,0,2500000,2500000,0
2021-10-01,Yala ,south,0.0215,999,1327,1327,0,2350000,2350000,0
2021-10-01,Nakhon Si Thammarat ,south,0.0742,7619,10942,10942,0,27450000,27450000,0
2021-10-01,Narathiwat ,south,0.0323,1094,1549,1549,0,2830000,2830000,0
2021-10-01,Krabi ,south,0.0218,4825,6644,6408,236,60730000,59480000,1250000
2021-10-01,Songkhla ,south,0.0331,5132,9362,9358,4,45600000,45590000,10000
2021-10-01,Phang Nga ,south,0.1127,23920,28887,21873,7014,134810000,75900000,58910000
2021-10-01,Surat Thani ,south,0.0579,6978,9650,6323,3327,64360000,32440000,31920000
2021-10-01,Satun ,south,0.058600000000000006,3334,4965,4960,5,15540000,15520000,20000
2021-10-01,Kamphaeng Phet ,north,0.08460000000000001,7489,10935,10935,0,14580000,14580000,0
2021-10-01,Chiang Rai ,north,0.2687,98956,116319,115525,794,489430000,485600000,3830000
2021-10-01,Chiang Mai ,north,0.20679999999999998,182337,214715,212787,1928,1139420000,1128800000,10620000
2021-10-01,Phichit ,north,0.0851,6447,11935,11935,0,13780000,13780000,0
2021-10-01,Nakhon Sawan ,north,0.1176,18256,28921,28763,158,47240000,46980000,260000
2021-10-01,Tak ,north,0.0935,17531,23928,23928,0,46260000,46260000,0
2021-10-01,Phitsanulok ,north,0.1628,37534,52678,52480,198,96220000,95820000,400000
2021-10-01,Phayao ,north,0.21489999999999998,10885,21386,21386,0,32500000,32500000,0
2021-10-01,Phetchabun ,north,0.2506,70220,84525,84467,58,171580000,171410000,170000
2021-10-01,Phrae ,north,0.18899999999999997,13132,19532,19532,0,25550000,25550000,0
2021-10-01,Lampang ,north,0.2596,20485,28742,28577,165,61200000,60810000,390000
2021-10-01,Lamphun ,north,0.261,9952,18167,18018,149,16850000,16700000,150000
2021-10-01,Mae Hong Son ,north,0.1653,31892,33309,33043,266,80600000,79800000,800000
2021-10-01,Uttaradit ,north,0.1082,10868,16832,16832,0,19470000,19470000,0
2021-10-01,Uthai Thani ,north,0.0475,2658,4910,4910,0,5030000,5030000,0
2021-10-01,Sukhothai ,north,0.0658,6884,18172,17814,358,29970000,29420000,550000
2021-10-01,Nan ,north,0.4903,47859,57643,57453,190,91360000,90940000,420000
2021-10-01,Kalasin ,east_northeast,0.15460000000000002,7138,31863,31863,0,23630000,23630000,0
2021-10-01,Khon Kaen ,east_northeast,0.1597,48194,78172,78172,0,101030000,101030000,0
2021-10-01,Chaiyaphum ,east_northeast,0.0666,10061,24350,24317,33,19680000,19640000,40000
2021-10-01,Nakhon Phanom ,east_northeast,0.1589,10617,22046,22046,0,20640000,20640000,0
2021-10-01,Nakhon Ratchasima ,east_northeast,0.21170000000000003,136393,236917,235237,1680,313370000,310140000,3230000
2021-10-01,Buriram ,east_northeast,0.1636,28406,48708,48574,134,69330000,69160000,170000
2021-10-01,Maha Sarakham ,east_northeast,0.09359999999999999,7736,12910,12885,25,10580000,10480000,100000
2021-10-01,Mukdahan ,east_northeast,0.1332,10136,38043,38043,0,41510000,41510000,0
2021-10-01,Roi Et ,east_northeast,0.1164,9259,17276,17276,0,11480000,11480000,0
2021-10-01,Loei ,east_northeast,0.1887,36480,83583,83511,72,67030000,66910000,120000
2021-10-01,Sisaket ,south,0.1278,7729,29110,29110,0,19130000,19130000,0
2021-10-01,Surin ,east_northeast,0.0922,14129,19225,19203,22,17610000,17580000,30000
2021-10-01,Nong Khai ,east_northeast,0.1121,16911,29617,29500,117,20140000,20000000,140000
2021-10-01,Bueng Kan ,east_northeast,0.0782,4176,7313,7296,17,7520000,7490000,30000
2021-10-01,Udon Thani ,east_northeast,0.11359999999999999,24458,44698,44548,150,75680000,75410000,270000
2021-10-01,Ubon Ratchathani ,east_northeast,0.1634,34785,60742,60742,0,68040000,68040000,0
2021-10-01,Sakon Nakhon ,east_northeast,0.1434,15960,37911,37911,0,27830000,27830000,0
2021-10-01,Yasothon ,east_northeast,0.0981,1925,6476,6476,0,4160000,4160000,0
2021-10-01,Amnat Charoen ,east_northeast,0.0911,1607,4821,4821,0,3540000,3540000,0
2021-10-01,Nong Bua Lamphu ,east_northeast,0.0412,1353,3417,3402,15,1710000,1690000,20000
2021-11-01,Bangkok,central,0.24170000000000003,507770,1294781,1215564,79217,3940330000,2913820000,1026510000
2021-11-01,Lopburi ,central,0.2553,35981,164681,164569,112,160950000,160830000,120000
2021-11-01,Phra Nakhon Si Ayutthaya ,central,0.34700000000000003,48387,389058,388198,860,520990000,519630000,1360000
2021-11-01,Saraburi ,central,0.26530000000000004,52117,213646,213508,138,206620000,206450000,170000
2021-11-01,Chainat ,central,0.2143,11945,44850,44850,0,40720000,40720000,0
2021-11-01,Nakhon Pathom ,central,0.2433,33083,116491,116387,104,119410000,119210000,200000
2021-11-01,Sing Buri ,central,0.1986,7742,22448,22402,46,29590000,29550000,40000
2021-11-01,Ang Thong ,central,0.1472,4113,28564,28564,0,23710000,23710000,0
2021-11-01,Nonthaburi ,central,0.2457,30475,91335,90985,350,103135000,102730000,405000
2021-11-01,Pathum Thani ,central,0.1789,21717,80926,80630,296,78572000,78250000,322000
2021-11-01,Samut Prakan ,central,0.1953,25275,65953,52911,13042,87660000,70310000,17350000
2021-11-01,Samut Sakhon ,central,0.1557,10700,27110,27075,35,25940000,25870000,70000
2021-11-01,Chachoengsao ,east,0.1826,11229,337607,337607,0,370770000,370770000,0
2021-11-01,Ratchaburi ,central,0.4211,62545,156792,156354,438,181910000,180580000,1330000
2021-11-01,Kanchanaburi ,central,0.47490000000000004,233580,812418,812043,375,1316330000,1315570000,760000
2021-11-01,Samut Songkhram ,central,0.20350000000000001,30625,103736,103736,0,105900000,105900000,0
2021-11-01,Suphan Buri ,central,0.3703,53647,279513,279513,0,298440000,298440000,0
2021-11-01,Phetchaburi ,central,0.4129,197179,479666,479543,123,1136970000,1136450000,520000
2021-11-01,Prachuap Khiri Khan ,central,0.3859,249212,450266,449376,890,1440630000,1431900000,8730000
2021-11-01,Chonburi ,east,0.3373,481065,929255,920898,8357,3405880000,3339120000,66760000
2021-11-01,Chanthaburi ,east,0.40950000000000003,92444,127398,127173,225,359740000,359200000,540000
2021-11-01,Trat ,east,0.2621,91952,106763,104219,2544,471450000,442440000,29010000
2021-11-01,Nakhon Nayok ,east,0.44079999999999997,92136,170824,170788,36,268120000,268120000,0
2021-11-01,Prachinburi ,east,0.3075,53872,86770,86638,132,152830000,152580000,250000
2021-11-01,Rayong ,east,0.38549999999999995,190848,449414,446915,2499,1106030000,1098460000,7570000
2021-11-01,Sa Kaeo ,east,0.2695,34877,80293,79161,1132,167300000,165290000,2010000
2021-11-01,Phuket ,south,0.1159,134273,158721,117533,41188,3334860000,909010000,2425850000
2021-11-01,Phatthalung ,south,0.0704,10528,19880,19880,0,24000000,24000000,0
2021-11-01,Trang ,south,0.1456,19893,25842,25842,0,110480000,110480000,0
2021-11-01,Ranong ,south,0.0724,8701,10718,10686,32,24630000,24520000,110000
2021-11-01,Chumphon ,south,0.1537,25995,33159,33146,13,98710000,98670000,40000
2021-11-01,Pattani ,south,0.1152,3670,4532,4532,0,10130000,10130000,0
2021-11-01,Yala ,south,0.1025,6468,8303,8303,0,15340000,15340000,0
2021-11-01,Nakhon Si Thammarat ,south,0.1679,16476,22828,22804,24,58310000,58230000,80000
2021-11-01,Narathiwat ,south,0.0653,2143,3051,3051,0,5710000,5710000,0
2021-11-01,Krabi ,south,0.0824,37452,49198,48852,346,450860000,449010000,1850000
2021-11-01,Songkhla ,south,0.06849999999999999,17554,24450,24434,16,118990000,118940000,50000
2021-11-01,Phang Nga ,south,0.154,27545,57579,43267,14312,252240000,130850000,121390000
2021-11-01,Surat Thani ,south,0.07429999999999999,22151,31940,27595,4345,200660000,158480000,42180000
2021-11-01,Satun ,south,0.2857,35512,53346,53307,39,157270000,157110000,160000
2021-11-01,Kamphaeng Phet ,north,0.2084,21266,40873,40710,163,58040000,57780000,260000
2021-11-01,Chiang Rai ,north,0.4925,206000,266159,265473,686,1180080000,1176560000,3520000
2021-11-01,Chiang Mai ,north,0.4054,488905,779417,775914,3503,4253620000,4233630000,19990000
2021-11-01,Phichit ,north,0.1523,12736,28128,28128,0,34890000,34890000,0
2021-11-01,Nakhon Sawan ,north,0.2268,40200,75335,75110,225,129550000,129120000,430000
2021-11-01,Tak ,north,0.15460000000000002,48326,65113,65113,0,138240000,138240000,0
2021-11-01,Phitsanulok ,north,0.3387,85446,147550,147235,315,281270000,280580000,690000
2021-11-01,Phayao ,north,0.4172,23966,52329,51787,542,83800000,82860000,940000
2021-11-01,Phetchabun ,north,0.4065,110087,134305,133818,487,290650000,289210000,1440000
2021-11-01,Phrae ,north,0.41960000000000003,28396,51804,51653,151,70710000,70480000,230000
2021-11-01,Lampang ,north,0.3704,34240,91037,90339,698,204450000,202670000,1780000
2021-11-01,Lamphun ,north,0.3421,13835,66278,65498,780,67730000,66750000,980000
2021-11-01,Mae Hong Son ,north,0.35869999999999996,70550,73223,71986,1237,187910000,184130000,3780000
2021-11-01,Uttaradit ,north,0.2869,32893,51788,51679,109,67130000,66960000,170000
2021-11-01,Uthai Thani ,north,0.1508,11732,33303,33303,0,38160000,38160000,0
2021-11-01,Sukhothai ,north,0.26839999999999997,34164,59322,58638,684,106540000,105190000,1350000
2021-11-01,Nan ,north,0.6876000000000001,78139,103582,102713,869,178030000,175980000,2050000
2021-11-01,Kalasin ,east_northeast,0.2925,14542,39828,39803,25,33490000,33490000,0
2021-11-01,Khon Kaen ,east_northeast,0.25980000000000003,87300,195487,195350,137,336740000,336470000,270000
2021-11-01,Chaiyaphum ,east_northeast,0.1906,27743,48905,48826,79,69920000,69770000,150000
2021-11-01,Nakhon Phanom ,east_northeast,0.3273,24012,60530,60511,19,71120000,71090000,30000
2021-11-01,Nakhon Ratchasima ,east_northeast,0.35600000000000004,271437,473887,472075,1812,709950000,705620000,4330000
2021-11-01,Buriram ,east_northeast,0.22390000000000002,40626,77399,76979,420,127710000,126980000,730000
2021-11-01,Maha Sarakham ,east_northeast,0.1338,11591,22566,22530,36,25120000,25010000,110000
2021-11-01,Mukdahan ,east_northeast,0.2818,26712,91851,91830,21,111770000,111700000,70000
2021-11-01,Roi Et ,east_northeast,0.1323,11535,29035,28998,37,29740000,29630000,110000
2021-11-01,Loei ,east_northeast,0.2605,67749,126076,125834,242,155890000,155450000,440000
2021-11-01,Sisaket ,south,0.2992,19132,51233,51233,0,54120000,54120000,0
2021-11-01,Surin ,east_northeast,0.1559,27818,36906,36878,28,45360000,45310000,50000
2021-11-01,Nong Khai ,east_northeast,0.2133,39184,88413,88064,349,109080000,108580000,500000
2021-11-01,Bueng Kan ,east_northeast,0.1155,7604,13820,13531,289,15160000,14600000,560000
2021-11-01,Udon Thani ,east_northeast,0.21289999999999998,52603,112923,112463,460,214390000,213370000,1020000
2021-11-01,Ubon Ratchathani ,east_northeast,0.2939,60500,119633,119591,42,154350000,154290000,60000
2021-11-01,Sakon Nakhon ,east_northeast,0.2859,46062,101215,101215,0,113710000,113710000,0
2021-11-01,Yasothon ,east_northeast,0.192,3808,11956,11956,0,10380000,10380000,0
2021-11-01,Amnat Charoen ,east_northeast,0.17550000000000002,3076,12411,12411,0,11650000,11650000,0
2021-11-01,Nong Bua Lamphu ,east_northeast,0.09699999999999999,3081,9330,9305,25,5180000,5150000,30000
2021-12-01,Bangkok,central,0.3176,1103572,2543615,2383978,159637,11975520000,9845110000,2130410000
2021-12-01,Lopburi ,central,0.3779,46497,265330,265144,186,329710000,329500000,210000
2021-12-01,Phra Nakhon Si Ayutthaya ,central,0.4861,66535,506314,497703,8611,731050000,717090000,13960000
2021-12-01,Saraburi ,central,0.3851,67399,308153,307750,403,453660000,452970000,690000
2021-12-01,Chainat ,central,0.34159999999999996,13622,51161,51147,14,71310000,71300000,10000
2021-12-01,Nakhon Pathom ,central,0.4118,68813,216272,216000,272,294060000,293290000,770000
2021-12-01,Sing Buri ,central,0.3003,10653,38697,38585,112,51980000,51880000,100000
2021-12-01,Ang Thong ,central,0.2133,5250,42587,42587,0,43800000,43800000,0
2021-12-01,Nonthaburi ,central,0.3546,53732,160119,158826,1293,213545000,211960000,1585000
2021-12-01,Pathum Thani ,central,0.2613,24549,105228,104299,929,147102000,146020000,1082000
2021-12-01,Samut Prakan ,central,0.28559999999999997,45307,148306,128665,19641,242680000,215060000,27620000
2021-12-01,Samut Sakhon ,central,0.27649999999999997,19349,49065,48960,105,48110000,47890000,220000
2021-12-01,Chachoengsao ,east,0.31120000000000003,23088,350064,349850,214,452240000,452060000,180000
2021-12-01,Ratchaburi ,central,0.5144,78987,187297,186671,626,221380000,219370000,2010000
2021-12-01,Kanchanaburi ,central,0.6073,268663,908851,907622,1229,1600710000,1596860000,3850000
2021-12-01,Samut Songkhram ,central,0.4935,66926,186767,186640,127,203030000,202760000,270000
2021-12-01,Suphan Buri ,central,0.5592,81825,346794,346794,0,392730000,392730000,0
2021-12-01,Phetchaburi ,central,0.5199,256513,596099,595951,148,1568770000,1568210000,560000
2021-12-01,Prachuap Khiri Khan ,central,0.5036,345371,595142,593435,1707,2103310000,2088080000,15230000
2021-12-01,Chonburi ,east,0.396,605407,975534,964356,11178,4310250000,4221380000,88870000
2021-12-01,Chanthaburi ,east,0.5962,96072,132403,132126,277,405600000,404930000,670000
2021-12-01,Trat ,east,0.39,122401,133130,130498,2632,632190000,602510000,29680000
2021-12-01,Nakhon Nayok ,east,0.493,85712,170360,170245,115,315980000,315600000,380000
2021-12-01,Prachinburi ,east,0.4043,57096,101944,101780,164,210810000,210490000,320000
2021-12-01,Rayong ,east,0.4953,227031,442667,440059,2608,1151800000,1143900000,7900000
2021-12-01,Sa Kaeo ,east,0.33149999999999996,39928,68672,68321,351,164520000,163810000,710000
2021-12-01,Phuket ,south,0.2638,232109,261943,167948,93995,6894580000,1347820000,5546760000
2021-12-01,Phatthalung ,south,0.1242,13705,39244,39244,0,50380000,50380000,0
2021-12-01,Trang ,south,0.4301,65707,91461,91339,122,354230000,353780000,450000
2021-12-01,Ranong ,south,0.1751,18793,21868,21760,108,54480000,54100000,380000
2021-12-01,Chumphon ,south,0.2773,53634,70890,70798,92,233710000,233420000,290000
2021-12-01,Pattani ,south,0.1672,5497,7237,7237,0,18360000,18360000,0
2021-12-01,Yala ,south,0.28559999999999997,39149,48470,48470,0,102750000,102750000,0
2021-12-01,Nakhon Si Thammarat ,south,0.2521,100284,138859,138776,83,414090000,413740000,350000
2021-12-01,Narathiwat ,south,0.0975,3429,5393,5393,0,11070000,11070000,0
2021-12-01,Krabi ,south,0.1649,67381,81255,79570,1685,816860000,807420000,9440000
2021-12-01,Songkhla ,south,0.1465,97294,111186,110907,279,597300000,596350000,950000
2021-12-01,Phang Nga ,south,0.3423,71975,174747,140351,34396,730750000,430700000,300050000
2021-12-01,Surat Thani ,south,0.1465,103356,132624,124431,8193,752440000,670200000,82240000
2021-12-01,Satun ,south,0.5141,77459,118953,118571,382,397140000,395560000,1580000
2021-12-01,Kamphaeng Phet ,north,0.32280000000000003,32290,60392,60106,286,94240000,93740000,500000
2021-12-01,Chiang Rai ,north,0.7051000000000001,278158,362358,360119,2239,2226830000,2211400000,15430000
2021-12-01,Chiang Mai ,north,0.6043,519976,817474,810928,6546,5186930000,5143010000,43920000
2021-12-01,Phichit ,north,0.2872,21361,47217,47125,92,72990000,72780000,210000
2021-12-01,Nakhon Sawan ,north,0.3514,58149,112947,112567,380,234840000,233840000,1000000
2021-12-01,Tak ,north,0.4061,88540,109369,109331,38,273940000,273820000,120000
2021-12-01,Phitsanulok ,north,0.4793,117368,202694,202078,616,436690000,435130000,1560000
2021-12-01,Phayao ,north,0.5689,30289,78112,77046,1066,145390000,143480000,1910000
2021-12-01,Phetchabun ,north,0.5436,155884,196178,195552,626,458800000,456930000,1870000
2021-12-01,Phrae ,north,0.6312,43759,91286,90937,349,143490000,142920000,570000
2021-12-01,Lampang ,north,0.6542,55540,147515,146727,788,392680000,389900000,2780000
2021-12-01,Lamphun ,north,0.5069,20295,95420,94339,1081,116200000,114780000,1420000
2021-12-01,Mae Hong Son ,north,0.5724,110345,114751,112339,2412,382980000,372840000,10140000
2021-12-01,Uttaradit ,north,0.33799999999999997,40990,74305,74146,159,101740000,101450000,290000
2021-12-01,Uthai Thani ,north,0.31010000000000004,16811,46752,46752,0,63220000,63220000,0
2021-12-01,Sukhothai ,north,0.42100000000000004,47055,77889,76248,1641,178860000,175260000,3600000
2021-12-01,Nan ,north,0.8654000000000001,91669,132711,131256,1455,287830000,282520000,5310000
2021-12-01,Kalasin ,east_northeast,0.33990000000000004,15823,44112,43792,320,43360000,43020000,340000
2021-12-01,Khon Kaen ,east_northeast,0.5234000000000001,158630,356626,354735,1891,899050000,894300000,4750000
2021-12-01,Chaiyaphum ,east_northeast,0.36920000000000003,56563,99618,99364,254,150490000,149940000,550000
2021-12-01,Nakhon Phanom ,east_northeast,0.6021,40155,101214,101189,25,129850000,129790000,60000
2021-12-01,Nakhon Ratchasima ,east_northeast,0.5376,345907,571339,566844,4495,884080000,873330000,10750000
2021-12-01,Buriram ,east_northeast,0.3865,66829,127140,126290,850,219310000,217620000,1690000
2021-12-01,Maha Sarakham ,east_northeast,0.2032,16635,33099,33059,40,41100000,40970000,130000
2021-12-01,Mukdahan ,east_northeast,0.37310000000000004,28211,96965,96923,42,133600000,133450000,150000
2021-12-01,Roi Et ,east_northeast,0.2223,17590,44247,44214,33,51100000,51000000,100000
2021-12-01,Loei ,east_northeast,0.42340000000000005,81647,143151,142378,773,181220000,179750000,1470000
2021-12-01,Sisaket ,south,0.4316,25889,69970,69958,12,80100000,80070000,30000
2021-12-01,Surin ,east_northeast,0.3747,57475,76048,75971,77,105830000,105690000,140000
2021-12-01,Nong Khai ,east_northeast,0.5204,78145,176894,176022,872,242880000,241590000,1290000
2021-12-01,Bueng Kan ,east_northeast,0.5121,27628,49966,49403,563,58010000,56860000,1150000
2021-12-01,Udon Thani ,east_northeast,0.4693,100037,215933,215261,672,430370000,428840000,1530000
2021-12-01,Ubon Ratchathani ,east_northeast,0.4982,106208,211200,211160,40,316310000,316250000,60000
2021-12-01,Sakon Nakhon ,east_northeast,0.5036,55976,123784,123753,31,150480000,150420000,60000
2021-12-01,Yasothon ,east_northeast,0.3382,12363,38817,38817,0,35710000,35710000,0
2021-12-01,Amnat Charoen ,east_northeast,0.36939999999999995,6518,26300,26300,0,26590000,26590000,0
2021-12-01,Nong Bua Lamphu ,east_northeast,0.2401,7886,23866,23805,61,15050000,14990000,60000
2022-01-01,Bangkok,central,0.2634,1009583,2437497,2299906,137591,11823610000,9642600000,2181010000
2022-01-01,Lopburi ,central,0.3859,47079,272813,272648,165,313370000,313200000,170000
2022-01-01,Phra Nakhon Si Ayutthaya ,central,0.4543,62040,525549,517228,8321,736610000,722640000,13970000
2022-01-01,Saraburi ,central,0.3738,65575,297994,297617,377,466210000,465600000,610000
2022-01-01,Chainat ,central,0.3566,13936,53856,53831,25,74080000,74060000,20000
2022-01-01,Nakhon Pathom ,central,0.3883,64805,207455,207244,211,277800000,277250000,550000
2022-01-01,Sing Buri ,central,0.33270000000000005,11376,41208,41073,135,53260000,53060000,200000
2022-01-01,Ang Thong ,central,0.2274,5603,47610,47596,14,46700000,46690000,10000
2022-01-01,Nonthaburi ,central,0.3381,50944,155264,153910,1354,198690000,197100000,1590000
2022-01-01,Pathum Thani ,central,0.24170000000000003,23507,100380,99371,1009,132040000,130880000,1160000
2022-01-01,Samut Prakan ,central,0.24739999999999998,41974,137207,120200,17007,211800000,188460000,23340000
2022-01-01,Samut Sakhon ,central,0.243,17876,47429,47296,133,45890000,45620000,270000
2022-01-01,Chachoengsao ,east,0.29469999999999996,21685,335492,335295,197,396740000,396580000,160000
2022-01-01,Ratchaburi ,central,0.4844,72252,126611,125870,741,147100000,145020000,2080000
2022-01-01,Kanchanaburi ,central,0.5717,223019,942486,940476,2010,1746150000,1739600000,6550000
2022-01-01,Samut Songkhram ,central,0.4334,56358,356495,356285,210,352620000,352180000,440000
2022-01-01,Suphan Buri ,central,0.43520000000000003,52073,246694,246314,380,298320000,297790000,530000
2022-01-01,Phetchaburi ,central,0.5221,258163,652324,652025,299,1725270000,1723910000,1360000
2022-01-01,Prachuap Khiri Khan ,central,0.4997,364053,674788,672283,2505,2370160000,2346990000,23170000
2022-01-01,Chonburi ,east,0.38520000000000004,644223,980622,917069,63553,6180570000,5152390000,1028180000
2022-01-01,Chanthaburi ,east,0.4022,67164,76001,75529,472,269520000,268560000,960000
2022-01-01,Trat ,east,0.32530000000000003,93739,101266,99088,2178,671530000,652870000,18660000
2022-01-01,Nakhon Nayok ,east,0.5185,78747,121765,121625,140,251220000,250870000,350000
2022-01-01,Prachinburi ,east,0.3979,53910,90676,90574,102,246770000,246400000,370000
2022-01-01,Rayong ,east,0.349,122400,165893,161806,4087,624770000,617920000,6850000
2022-01-01,Sa Kaeo ,east,0.29600000000000004,24962,58214,57752,462,196310000,195000000,1310000
2022-01-01,Phuket ,south,0.2553,223405,256193,165798,90395,6647770000,1341930000,5305840000
2022-01-01,Phatthalung ,south,0.2632,33169,46586,46501,85,69930000,69740000,190000
2022-01-01,Trang ,south,0.3124,46898,58720,58531,189,239590000,238910000,680000
2022-01-01,Ranong ,south,0.3024,27987,36390,36045,345,101010000,99820000,1190000
2022-01-01,Chumphon ,south,0.2877,57247,69338,69228,110,231270000,230940000,330000
2022-01-01,Pattani ,south,0.275,11945,14683,14683,0,40010000,40010000,0
2022-01-01,Yala ,south,0.3763,47655,54867,54867,0,114610000,114610000,0
2022-01-01,Nakhon Si Thammarat ,south,0.2329,87708,135711,135599,112,413000000,412600000,400000
2022-01-01,Narathiwat ,south,0.1941,14387,17075,17075,0,36680000,36680000,0
2022-01-01,Krabi ,south,0.2556,106708,151771,131467,20304,1647660000,1500900000,146760000
2022-01-01,Songkhla ,south,0.16649999999999998,106962,150822,150656,166,918990000,917690000,1300000
2022-01-01,Phang Nga ,south,0.32280000000000003,57525,120090,83378,36712,626680000,286710000,339970000
2022-01-01,Surat Thani ,south,0.24489999999999998,153446,186906,164440,22466,1203950000,979190000,224760000
2022-01-01,Satun ,south,0.4521,65373,118127,117343,784,492460000,488970000,3490000
2022-01-01,Kamphaeng Phet ,north,0.3558,31459,56492,56102,390,91950000,91280000,670000
2022-01-01,Chiang Rai ,north,0.7209,312079,399487,396239,3248,2678100000,2650110000,27990000
2022-01-01,Chiang Mai ,north,0.5683,467344,757609,745250,12359,4596000000,4503460000,92540000
2022-01-01,Phichit ,north,0.33509999999999995,23957,49385,49267,118,79320000,79070000,250000
2022-01-01,Nakhon Sawan ,north,0.41590000000000005,60620,114370,113905,465,249300000,248030000,1270000
2022-01-01,Tak ,north,0.4326,89556,115902,115838,64,315630000,315380000,250000
2022-01-01,Phitsanulok ,north,0.5574,141208,239815,239044,771,526630000,524620000,2010000
2022-01-01,Phayao ,north,0.5803,32699,77106,75925,1181,132260000,129940000,2320000
2022-01-01,Phetchabun ,north,0.6052000000000001,160971,191763,190838,925,499300000,496720000,2580000
2022-01-01,Phrae ,north,0.6409999999999999,44751,89699,89214,485,148740000,147810000,930000
2022-01-01,Lampang ,north,0.5249,49467,131566,130634,932,333750000,330120000,3630000
2022-01-01,Lamphun ,north,0.4951,19870,89374,88141,1233,110800000,108950000,1850000
2022-01-01,Mae Hong Son ,north,0.5059,96123,101424,98165,3259,351860000,337390000,14470000
2022-01-01,Uttaradit ,north,0.36869999999999997,37996,67157,66971,186,96820000,96450000,370000
2022-01-01,Uthai Thani ,north,0.3164,19617,47746,47641,105,68210000,68000000,210000
2022-01-01,Sukhothai ,north,0.3458,45089,73766,71780,1986,159600000,154770000,4830000
2022-01-01,Nan ,north,0.7189,77653,112097,110502,1595,257480000,249610000,7870000
2022-01-01,Kalasin ,east_northeast,0.3823,18956,54514,54354,160,51730000,51730000,0
2022-01-01,Khon Kaen ,east_northeast,0.4642,140983,287088,285370,1718,704610000,699510000,5100000
2022-01-01,Chaiyaphum ,east_northeast,0.3156,54377,96982,96703,279,140710000,140130000,580000
2022-01-01,Nakhon Phanom ,east_northeast,0.5427000000000001,36671,94429,93150,1279,117470000,114680000,2790000
2022-01-01,Nakhon Ratchasima ,east_northeast,0.4867,303535,473933,470559,3374,740660000,733350000,7310000
2022-01-01,Buriram ,east_northeast,0.6159,113745,196609,195466,1143,367720000,365620000,2100000
2022-01-01,Maha Sarakham ,east_northeast,0.1766,12789,24769,24565,204,31280000,30640000,640000
2022-01-01,Mukdahan ,east_northeast,0.3843,30146,113407,112071,1336,152650000,148250000,4400000
2022-01-01,Roi Et ,east_northeast,0.2815,21171,49690,49386,304,62690000,61760000,930000
2022-01-01,Loei ,east_northeast,0.3726,78804,136136,135662,474,237270000,235950000,1320000
2022-01-01,Sisaket ,south,0.43700000000000006,25586,70912,70789,123,80680000,80370000,310000
2022-01-01,Surin ,east_northeast,0.32,48872,66730,66459,271,115750000,115210000,540000
2022-01-01,Nong Khai ,east_northeast,0.49369999999999997,65972,159734,159221,513,216420000,215540000,880000
2022-01-01,Bueng Kan ,east_northeast,0.6489,36733,81273,80807,466,105270000,104260000,1010000
2022-01-01,Udon Thani ,east_northeast,0.4158,83266,195756,195123,633,389320000,387350000,1970000
2022-01-01,Ubon Ratchathani ,east_northeast,0.4318,86656,197442,197257,185,248870000,248470000,400000
2022-01-01,Sakon Nakhon ,east_northeast,0.30219999999999997,33934,102354,101775,579,100140000,98590000,1550000
2022-01-01,Yasothon ,east_northeast,0.3771,10368,34454,34385,69,33250000,33100000,150000
2022-01-01,Amnat Charoen ,east_northeast,0.3736,6918,22648,22568,80,24930000,24690000,240000
2022-01-01,Nong Bua Lamphu ,east_northeast,0.1885,5881,20267,20267,0,14450000,14450000,0
2022-02-01,Bangkok,central,0.2884,1044609,2501208,2343918,157290,12279060000,9927650000,2351410000
2022-02-01,Lopburi ,central,0.4767,58128,335198,334850,348,379100000,378750000,350000
2022-02-01,Phra Nakhon Si Ayutthaya ,central,0.49939999999999996,67617,564358,556911,7447,813820000,801410000,12410000
2022-02-01,Saraburi ,central,0.3689,64704,279836,279504,332,432530000,432000000,530000
2022-02-01,Chainat ,central,0.3638,14216,55261,55239,22,75110000,75090000,20000
2022-02-01,Nakhon Pathom ,central,0.3538,59051,189041,188863,178,252330000,251870000,460000
2022-02-01,Sing Buri ,central,0.3785,12825,45926,45779,147,58360000,58130000,230000
2022-02-01,Ang Thong ,central,0.2447,6080,51475,51475,0,50140000,50140000,0
2022-02-01,Nonthaburi ,central,0.30269999999999997,45688,139215,137975,1240,176360000,174890000,1470000
2022-02-01,Pathum Thani ,central,0.2071,20294,88227,87284,943,115790000,114680000,1110000
2022-02-01,Samut Prakan ,central,0.2804,47039,146520,127329,19191,222910000,196970000,25940000
2022-02-01,Samut Sakhon ,central,0.2164,16011,38905,38816,89,37570000,37390000,180000
2022-02-01,Chachoengsao ,east,0.3072,22855,343718,343491,227,401740000,401530000,210000
2022-02-01,Ratchaburi ,central,0.4576,68271,119711,119102,609,136080000,134450000,1630000
2022-02-01,Kanchanaburi ,central,0.5513,211948,915118,912695,2423,1701460000,1693120000,8340000
2022-02-01,Samut Songkhram ,central,0.4117,53648,336567,336304,263,333820000,333320000,500000
2022-02-01,Suphan Buri ,central,0.42479999999999996,51048,243117,242734,383,286310000,285800000,510000
2022-02-01,Phetchaburi ,central,0.5586,278172,699841,699413,428,1820200000,1818330000,1870000
2022-02-01,Prachuap Khiri Khan ,central,0.5103,373183,707563,703568,3995,2361830000,2324880000,36950000
2022-02-01,Chonburi ,east,0.3522,610252,961479,911339,50140,5874860000,5061740000,813120000
2022-02-01,Chanthaburi ,east,0.49329999999999996,76573,113235,112702,533,415000000,413860000,1140000
2022-02-01,Trat ,east,0.308,90813,97998,96123,1875,647690000,633330000,14360000
2022-02-01,Nakhon Nayok ,east,0.488,73692,120143,120022,121,240230000,239920000,310000
2022-02-01,Prachinburi ,east,0.35969999999999996,49930,84165,84074,91,235050000,234710000,340000
2022-02-01,Rayong ,east,0.305,116771,153567,150122,3445,575450000,570060000,5390000
2022-02-01,Sa Kaeo ,east,0.3471,30632,83160,82673,487,282960000,281560000,1400000
2022-02-01,Phuket ,south,0.24559999999999998,214002,248965,161030,87935,6514080000,1297600000,5216480000
2022-02-01,Phatthalung ,south,0.2073,18795,28711,28711,0,39940000,39940000,0
2022-02-01,Trang ,south,0.4075,57927,73970,73646,324,308670000,307480000,1190000
2022-02-01,Ranong ,south,0.287,24745,30149,29860,289,81170000,80200000,970000
2022-02-01,Chumphon ,south,0.3145,60127,74796,74702,94,252010000,251720000,290000
2022-02-01,Pattani ,south,0.3068,13413,17366,17366,0,48020000,48020000,0
2022-02-01,Yala ,south,0.4654,53238,63363,63363,0,136720000,136720000,0
2022-02-01,Nakhon Si Thammarat ,south,0.21760000000000002,77861,121785,121703,82,376910000,376620000,290000
2022-02-01,Narathiwat ,south,0.2157,17895,21128,21128,0,45800000,45800000,0
2022-02-01,Krabi ,south,0.1528,73468,108113,94204,13909,1163450000,1064670000,98780000
2022-02-01,Songkhla ,south,0.1425,85488,121047,120928,119,729020000,728100000,920000
2022-02-01,Phang Nga ,south,0.28300000000000003,41856,92001,64277,27724,465960000,218410000,247550000
2022-02-01,Surat Thani ,south,0.2838,166484,211853,183559,28294,1404280000,1125050000,279230000
2022-02-01,Satun ,south,0.5035000000000001,70478,128051,127178,873,542940000,538980000,3960000
2022-02-01,Kamphaeng Phet ,north,0.38539999999999996,32186,58810,58375,435,97290000,96490000,800000
2022-02-01,Chiang Rai ,north,0.7943000000000001,333128,420865,417125,3740,2844440000,2810560000,33880000
2022-02-01,Chiang Mai ,north,0.6089,482851,773191,755855,17336,4876190000,4743160000,133030000
2022-02-01,Phichit ,north,0.3514,24669,50339,50266,73,81350000,81190000,160000
2022-02-01,Nakhon Sawan ,north,0.4362,61329,113275,112710,565,255960000,254310000,1650000
2022-02-01,Tak ,north,0.4458,91902,119864,119767,97,325450000,325060000,390000
2022-02-01,Phitsanulok ,north,0.456,114358,203706,202750,956,435830000,433260000,2570000
2022-02-01,Phayao ,north,0.6672,36534,85610,84186,1424,146040000,142820000,3220000
2022-02-01,Phetchabun ,north,0.5168,154485,177415,176123,1292,477530000,473800000,3730000
2022-02-01,Phrae ,north,0.6014,39469,82387,81735,652,142980000,141640000,1340000
2022-02-01,Lampang ,north,0.4581,39822,100456,99818,638,263780000,261270000,2510000
2022-02-01,Lamphun ,north,0.4257,15047,68028,66466,1562,88530000,86010000,2520000
2022-02-01,Mae Hong Son ,north,0.4253,76310,80951,77232,3719,293490000,276290000,17200000
2022-02-01,Uttaradit ,north,0.40340000000000004,38125,60760,60536,224,89180000,88710000,470000
2022-02-01,Uthai Thani ,north,0.3674,20837,47652,47652,0,75940000,75940000,0
2022-02-01,Sukhothai ,north,0.2682,36444,55606,54431,1175,120920000,117950000,2970000
2022-02-01,Nan ,north,0.7365,81108,111934,110193,1741,275700000,267250000,8450000
2022-02-01,Kalasin ,east_northeast,0.3688,17238,49542,49451,91,44310000,44000000,310000
2022-02-01,Khon Kaen ,east_northeast,0.3933,119071,242105,240987,1118,566600000,563470000,3130000
2022-02-01,Chaiyaphum ,east_northeast,0.2724,48096,85793,85619,174,117050000,116750000,300000
2022-02-01,Nakhon Phanom ,east_northeast,0.5629,38944,100765,100062,703,127550000,126040000,1510000
2022-02-01,Nakhon Ratchasima ,east_northeast,0.47159999999999996,298018,481675,479824,1851,738670000,734790000,3880000
2022-02-01,Buriram ,east_northeast,0.5027,97166,191892,191359,533,395530000,394650000,880000
2022-02-01,Maha Sarakham ,east_northeast,0.203,16781,32566,32455,111,35520000,35220000,300000
2022-02-01,Mukdahan ,east_northeast,0.41090000000000004,31768,118055,117209,846,157380000,155170000,2210000
2022-02-01,Roi Et ,east_northeast,0.2576,19038,44689,44524,165,57510000,57110000,400000
2022-02-01,Loei ,east_northeast,0.35119999999999996,75563,127712,127357,355,208060000,207110000,950000
2022-02-01,Sisaket ,south,0.45049999999999996,27821,77116,77057,59,89290000,89170000,120000
2022-02-01,Surin ,east_northeast,0.27390000000000003,40668,55530,55353,177,90960000,90640000,320000
2022-02-01,Nong Khai ,east_northeast,0.4236,51510,124709,124225,484,162960000,162190000,770000
2022-02-01,Bueng Kan ,east_northeast,0.5127,31300,59426,59019,407,74970000,74180000,790000
2022-02-01,Udon Thani ,east_northeast,0.4814,95340,224154,223614,540,425190000,423560000,1630000
2022-02-01,Ubon Ratchathani ,east_northeast,0.3297,69782,159010,158855,155,200480000,200210000,270000
2022-02-01,Sakon Nakhon ,east_northeast,0.3396,39216,111991,111646,345,114130000,113230000,900000
2022-02-01,Yasothon ,east_northeast,0.3538,8820,29301,29263,38,26890000,26820000,70000
2022-02-01,Amnat Charoen ,east_northeast,0.2844,5244,17145,17107,38,17390000,17310000,80000
2022-02-01,Nong Bua Lamphu ,east_northeast,0.19440000000000002,5953,20515,20515,0,14940000,14940000,0
2022-03-01,Bangkok,central,0.3378,1114806,2624483,2400409,224074,15466540000,11572130000,3894410000
2022-03-01,Lopburi ,central,0.4875,58801,348983,348574,409,392160000,391750000,410000
2022-03-01,Phra Nakhon Si Ayutthaya ,central,0.48710000000000003,66003,551475,543447,8028,803940000,789720000,14220000
2022-03-01,Saraburi ,central,0.3738,65767,297382,297027,355,450870000,450330000,540000
2022-03-01,Chainat ,central,0.43579999999999997,15586,62819,62782,37,84440000,84410000,30000
2022-03-01,Nakhon Pathom ,central,0.41450000000000004,63587,201744,201541,203,266760000,266250000,510000
2022-03-01,Sing Buri ,central,0.39549999999999996,13273,50753,50582,171,61050000,60790000,260000
2022-03-01,Ang Thong ,central,0.3237,6882,58593,58593,0,56370000,56370000,0
2022-03-01,Nonthaburi ,central,0.3264,47455,150179,149319,860,188380000,187380000,1000000
2022-03-01,Pathum Thani ,central,0.2329,21242,93544,92877,667,121730000,120690000,1040000
2022-03-01,Samut Prakan ,central,0.2612,44928,141028,123164,17864,213160000,189390000,23770000
2022-03-01,Samut Sakhon ,central,0.2254,17262,42418,42315,103,56820000,56610000,210000
2022-03-01,Chachoengsao ,east,0.2965,22017,337803,337617,186,392310000,392140000,170000
2022-03-01,Ratchaburi ,central,0.4396,63293,123361,122801,560,140970000,139410000,1560000
2022-03-01,Kanchanaburi ,central,0.5666,222043,923173,920258,2915,1720110000,1710110000,10000000
2022-03-01,Samut Songkhram ,central,0.41119999999999995,52844,326738,326479,259,320710000,320240000,470000
2022-03-01,Suphan Buri ,central,0.4514,54027,253775,253426,349,301810000,301390000,420000
2022-03-01,Phetchaburi ,central,0.6331,303196,725505,725031,474,1913150000,1911060000,2090000
2022-03-01,Prachuap Khiri Khan ,central,0.5625,383479,737321,733196,4125,2438680000,2400220000,38460000
2022-03-01,Chonburi ,east,0.418,652090,998371,962989,35382,6034540000,5485370000,549170000
2022-03-01,Chanthaburi ,east,0.4867,76026,115139,114564,575,382550000,381060000,1490000
2022-03-01,Trat ,east,0.4545,103941,112266,110557,1709,709250000,695560000,13690000
2022-03-01,Nakhon Nayok ,east,0.4217,68549,110003,109960,43,228730000,228610000,120000
2022-03-01,Prachinburi ,east,0.32799999999999996,48510,82576,82460,116,215250000,214830000,420000
2022-03-01,Rayong ,east,0.3761,126386,166253,162472,3781,590340000,582940000,7400000
2022-03-01,Sa Kaeo ,east,0.3225,30171,81003,80694,309,258640000,257780000,860000
2022-03-01,Phuket ,south,0.285,230261,274802,172762,102040,7259890000,1352010000,5907880000
2022-03-01,Phatthalung ,south,0.22460000000000002,19678,30159,30159,0,40950000,40950000,0
2022-03-01,Trang ,south,0.3531,53553,67606,67338,268,276770000,275810000,960000
2022-03-01,Ranong ,south,0.3275,26635,33145,32804,341,86740000,85630000,1110000
2022-03-01,Chumphon ,south,0.35200000000000004,64223,79831,79705,126,261230000,260850000,380000
2022-03-01,Pattani ,south,0.2849,12894,16195,16195,0,43530000,43530000,0
2022-03-01,Yala ,south,0.4482,52196,61945,61945,0,128760000,128760000,0
2022-03-01,Nakhon Si Thammarat ,south,0.2455,81685,127190,127082,108,386780000,386410000,370000
2022-03-01,Narathiwat ,south,0.23559999999999998,18717,22292,22292,0,46930000,46930000,0
2022-03-01,Krabi ,south,0.2032,79523,118958,102667,16291,1233220000,1120260000,112960000
2022-03-01,Songkhla ,south,0.15259999999999999,88983,126521,126382,139,746460000,745410000,1050000
2022-03-01,Phang Nga ,south,0.3098,43165,96676,65910,30766,487430000,221730000,265700000
2022-03-01,Surat Thani ,south,0.3086,186835,231602,186933,44669,1769510000,1186200000,583310000
2022-03-01,Satun ,south,0.5338,74815,136599,135787,812,563210000,559620000,3590000
2022-03-01,Kamphaeng Phet ,north,0.35229999999999995,30762,56254,55693,561,95270000,94200000,1070000
2022-03-01,Chiang Rai ,north,0.6870999999999999,293186,369703,365029,4674,2461910000,2415900000,46010000
2022-03-01,Chiang Mai ,north,0.4587,415914,651716,630195,21521,4294600000,4121920000,172680000
2022-03-01,Phichit ,north,0.3652,25635,49406,49317,89,78320000,78120000,200000
2022-03-01,Nakhon Sawan ,north,0.439,66219,121170,120309,861,267730000,264930000,2800000
2022-03-01,Tak ,north,0.3982,88524,112104,111979,125,316530000,316020000,510000
2022-03-01,Phitsanulok ,north,0.4036,108434,192361,190955,1406,421830000,417870000,3960000
2022-03-01,Phayao ,north,0.5971,34282,78912,77083,1829,132410000,128050000,4360000
2022-03-01,Phetchabun ,north,0.3985,128621,149045,147119,1926,421720000,416070000,5650000
2022-03-01,Phrae ,north,0.5436,35031,75739,75046,693,135390000,133920000,1470000
2022-03-01,Lampang ,north,0.42829999999999996,38027,96872,96209,663,258460000,255810000,2650000
2022-03-01,Lamphun ,north,0.39159999999999995,14705,66142,64344,1798,88100000,85120000,2980000
2022-03-01,Mae Hong Son ,north,0.3542,70163,74357,69703,4654,281710000,258690000,23020000
2022-03-01,Uttaradit ,north,0.3251,35810,56288,56018,270,83150000,82560000,590000
2022-03-01,Uthai Thani ,north,0.4302,23690,54091,54091,0,82780000,82780000,0
2022-03-01,Sukhothai ,north,0.2957,38185,58337,56881,1456,129690000,125940000,3750000
2022-03-01,Nan ,north,0.7138,77918,102594,100785,1809,253620000,244700000,8920000
2022-03-01,Kalasin ,east_northeast,0.3766,17855,51314,51215,99,47360000,47040000,320000
2022-03-01,Khon Kaen ,east_northeast,0.4089,125832,255859,254668,1191,621230000,617850000,3380000
2022-03-01,Chaiyaphum ,east_northeast,0.33140000000000003,51656,92134,91948,186,127320000,126970000,350000
2022-03-01,Nakhon Phanom ,east_northeast,0.6039,41813,108137,107416,721,143920000,142340000,1580000
2022-03-01,Nakhon Ratchasima ,east_northeast,0.45399999999999996,286543,463252,460932,2320,688420000,683510000,4910000
2022-03-01,Buriram ,east_northeast,0.5256000000000001,104670,207145,206553,592,439910000,438860000,1050000
2022-03-01,Maha Sarakham ,east_northeast,0.28800000000000003,18456,35777,35536,241,41500000,40820000,680000
2022-03-01,Mukdahan ,east_northeast,0.42719999999999997,34108,126811,125959,852,169070000,166840000,2230000
2022-03-01,Roi Et ,east_northeast,0.2731,20356,47783,47598,185,62530000,62070000,460000
2022-03-01,Loei ,east_northeast,0.3907,75636,127716,127128,588,243370000,241620000,1750000
2022-03-01,Sisaket ,south,0.5503,30936,85743,85656,87,100840000,100660000,180000
2022-03-01,Surin ,east_northeast,0.3408,45984,62788,62594,194,104450000,104080000,370000
2022-03-01,Nong Khai ,east_northeast,0.4472,56387,136428,135035,1393,190900000,188380000,2520000
2022-03-01,Bueng Kan ,east_northeast,0.4789,28646,54415,54084,331,66890000,66250000,640000
2022-03-01,Udon Thani ,east_northeast,0.4233,91327,214866,213774,1092,424030000,420660000,3370000
2022-03-01,Ubon Ratchathani ,east_northeast,0.35850000000000004,75508,172048,171867,181,223470000,223130000,340000
2022-03-01,Sakon Nakhon ,east_northeast,0.35619999999999996,40723,113897,113588,309,118560000,117740000,820000
2022-03-01,Yasothon ,east_northeast,0.36340000000000006,9403,31233,31187,46,29420000,29330000,90000
2022-03-01,Amnat Charoen ,east_northeast,0.2463,4884,15971,15939,32,15910000,15850000,60000
2022-03-01,Nong Bua Lamphu ,east_northeast,0.2205,6075,20929,20901,28,15570000,15550000,20000
2022-04-01,Bangkok,central,0.3693,1188983,2802633,2552838,249795,17642240000,13098350000,4543890000
2022-04-01,Lopburi ,central,0.5216,63311,372372,372166,206,409270000,409010000,260000
2022-04-01,Phra Nakhon Si Ayutthaya ,central,0.5302,72343,627393,619019,8374,950470000,933280000,17190000
2022-04-01,Saraburi ,central,0.46240000000000003,72870,331631,331170,461,505110000,504460000,650000
2022-04-01,Chainat ,central,0.4496,16146,71508,71460,48,90640000,90600000,40000
2022-04-01,Nakhon Pathom ,central,0.4499,66896,235375,235156,219,309750000,309180000,570000
2022-04-01,Sing Buri ,central,0.4235,14007,57011,56924,87,70330000,70160000,170000
2022-04-01,Ang Thong ,central,0.3367,7288,64111,64111,0,59740000,59740000,0
2022-04-01,Nonthaburi ,central,0.35350000000000004,49921,161996,161320,676,199650000,198800000,850000
2022-04-01,Pathum Thani ,central,0.2626,22620,101228,100543,685,128380000,127330000,1050000
2022-04-01,Samut Prakan ,central,0.29359999999999997,47242,161210,141968,19242,231580000,206430000,25150000
2022-04-01,Samut Sakhon ,central,0.2463,18017,51184,51106,78,65400000,65250000,150000
2022-04-01,Chachoengsao ,east,0.3326,23766,391060,390826,234,425490000,425280000,210000
2022-04-01,Ratchaburi ,central,0.5407,71668,140100,139200,900,164990000,162610000,2380000
2022-04-01,Kanchanaburi ,central,0.6017,235975,978729,974480,4249,1767150000,1752570000,14580000
2022-04-01,Samut Songkhram ,central,0.4612,59193,340004,338924,1080,342210000,340210000,2000000
2022-04-01,Suphan Buri ,central,0.509,60804,287610,287183,427,349710000,349180000,530000
2022-04-01,Phetchaburi ,central,0.6491,313166,771505,769101,2404,2078610000,2069820000,8790000
2022-04-01,Prachuap Khiri Khan ,central,0.5893999999999999,402368,795506,789036,6470,2621910000,2561950000,59960000
2022-04-01,Chonburi ,east,0.47840000000000005,687744,1049243,1012390,36853,6425170000,5920290000,504880000
2022-04-01,Chanthaburi ,east,0.5379999999999999,81657,119568,118776,792,392370000,390720000,1650000
2022-04-01,Trat ,east,0.5192,109675,120141,116510,3631,788790000,769620000,19170000
2022-04-01,Nakhon Nayok ,east,0.4853,72944,117078,117000,78,265210000,264990000,220000
2022-04-01,Prachinburi ,east,0.3663,51442,87060,86858,202,233010000,232260000,750000
2022-04-01,Rayong ,east,0.4793,144927,217577,210259,7318,696570000,677670000,18900000
2022-04-01,Sa Kaeo ,east,0.3862,33186,91006,90651,355,276830000,275840000,990000
2022-04-01,Phuket ,south,0.315,245225,302292,181975,120317,8147670000,1384270000,6763400000
2022-04-01,Phatthalung ,south,0.3054,21770,34899,34899,0,46050000,46050000,0
2022-04-01,Trang ,south,0.4561,60693,87892,87403,489,350320000,348610000,1710000
2022-04-01,Ranong ,south,0.3924,28923,39199,38666,533,99980000,98280000,1700000
2022-04-01,Chumphon ,south,0.42469999999999997,70243,86611,86457,154,273890000,273440000,450000
2022-04-01,Pattani ,south,0.2659,12477,15463,15463,0,40260000,40260000,0
2022-04-01,Yala ,south,0.4732,54685,65938,65938,0,133160000,133160000,0
2022-04-01,Nakhon Si Thammarat ,south,0.3331,90224,139117,138969,148,411480000,410980000,500000
2022-04-01,Narathiwat ,south,0.21530000000000002,17911,21117,21117,0,43040000,43040000,0
2022-04-01,Krabi ,south,0.293,87664,152948,131218,21730,1528910000,1381420000,147490000
2022-04-01,Songkhla ,south,0.20739999999999997,96095,138194,135441,2753,800490000,780090000,20400000
2022-04-01,Phang Nga ,south,0.40380000000000005,48572,123762,88426,35336,587370000,291530000,295840000
2022-04-01,Surat Thani ,south,0.4336,215562,284020,229822,54198,2228670000,1517750000,710920000
2022-04-01,Satun ,south,0.5663,79048,148015,146457,1558,592190000,585460000,6730000
2022-04-01,Kamphaeng Phet ,north,0.32899999999999996,28955,70459,69613,846,117370000,115700000,1670000
2022-04-01,Chiang Rai ,north,0.6459,284500,371873,366843,5030,2422700000,2370180000,52520000
2022-04-01,Chiang Mai ,north,0.5073,439564,699044,677236,21808,4654730000,4474670000,180060000
2022-04-01,Phichit ,north,0.4428,27993,58795,58736,59,91630000,91480000,150000
2022-04-01,Nakhon Sawan ,north,0.4561,68175,135474,134398,1076,310140000,306580000,3560000
2022-04-01,Tak ,north,0.4058,90123,117967,117828,139,339530000,338950000,580000
2022-04-01,Phitsanulok ,north,0.3883,105237,205734,204107,1627,475740000,471460000,4280000
2022-04-01,Phayao ,north,0.6248,35527,81290,78973,2317,148240000,142510000,5730000
2022-04-01,Phetchabun ,north,0.31620000000000004,113958,157731,155598,2133,463060000,456700000,6360000
2022-04-01,Phrae ,north,0.6078,37883,102980,102301,679,198480000,197020000,1460000
2022-04-01,Lampang ,north,0.5021,41533,121810,121105,705,305100000,302270000,2830000
2022-04-01,Lamphun ,north,0.4782,16631,95419,93474,1945,110530000,106830000,3700000
2022-04-01,Mae Hong Son ,north,0.2354,56273,70668,66240,4428,275870000,253340000,22530000
2022-04-01,Uttaradit ,north,0.2713,32904,72755,72548,207,91920000,91480000,440000
2022-04-01,Uthai Thani ,north,0.396,22326,80632,80632,0,112570000,112570000,0
2022-04-01,Sukhothai ,north,0.2594,36168,65893,64095,1798,136490000,131780000,4710000
2022-04-01,Nan ,north,0.6857,73923,105886,104184,1702,233510000,225340000,8170000
2022-04-01,Kalasin ,east_northeast,0.4028,18917,53543,53433,110,50770000,50410000,360000
2022-04-01,Khon Kaen ,east_northeast,0.45399999999999996,131936,264742,263496,1246,681630000,677940000,3690000
2022-04-01,Chaiyaphum ,east_northeast,0.4311,55357,99674,99462,212,141650000,141220000,430000
2022-04-01,Nakhon Phanom ,east_northeast,0.6234000000000001,44412,111568,110787,781,149840000,147970000,1870000
2022-04-01,Nakhon Ratchasima ,east_northeast,0.5468,310218,514005,510381,3624,823680000,812720000,10960000
2022-04-01,Buriram ,east_northeast,0.6031,111676,219398,218783,615,470060000,468720000,1340000
2022-04-01,Maha Sarakham ,east_northeast,0.6087,26861,46965,46687,278,57470000,56670000,800000
2022-04-01,Mukdahan ,east_northeast,0.45409999999999995,35538,131945,130985,960,179040000,176510000,2530000
2022-04-01,Roi Et ,east_northeast,0.3297,21801,50877,50658,219,67140000,66570000,570000
2022-04-01,Loei ,east_northeast,0.4654,80905,134366,133767,599,252090000,250190000,1900000
2022-04-01,Sisaket ,south,0.42729999999999996,25824,75891,75811,80,86140000,85980000,160000
2022-04-01,Surin ,east_northeast,0.40149999999999997,49128,66552,66347,205,119340000,118910000,430000
2022-04-01,Nong Khai ,east_northeast,0.46159999999999995,59097,140873,139395,1478,205710000,202970000,2740000
2022-04-01,Bueng Kan ,east_northeast,0.5025999999999999,30086,59374,59029,345,76830000,76130000,700000
2022-04-01,Udon Thani ,east_northeast,0.4532,97916,228830,227675,1155,455130000,451400000,3730000
2022-04-01,Ubon Ratchathani ,east_northeast,0.3789,77886,175531,175291,240,243570000,242990000,580000
2022-04-01,Sakon Nakhon ,east_northeast,0.41590000000000005,42738,118661,118306,355,159260000,158260000,1000000
2022-04-01,Yasothon ,east_northeast,0.3883,9954,32886,32830,56,31480000,31370000,110000
2022-04-01,Amnat Charoen ,east_northeast,0.2614,5405,17181,17138,43,18250000,18160000,90000
2022-04-01,Nong Bua Lamphu ,east_northeast,0.3056,6858,21801,21764,37,16730000,16700000,30000
2022-05-01,Bangkok,central,0.39909999999999995,1223923,2738889,2215993,522896,20299160000,11120520000,9178640000
2022-05-01,Lopburi ,central,0.47869999999999996,58179,359912,359648,264,398350000,398000000,350000
2022-05-01,Phra Nakhon Si Ayutthaya ,central,0.5119,70579,630760,624230,6530,965970000,950380000,15590000
2022-05-01,Saraburi ,central,0.4163,65891,309609,309237,372,475490000,474950000,540000
2022-05-01,Chainat ,central,0.41609999999999997,15003,65680,65597,83,82200000,82130000,70000
2022-05-01,Nakhon Pathom ,central,0.4174,62115,218320,218036,284,288990000,288270000,720000
2022-05-01,Sing Buri ,central,0.3911,13093,49725,49556,169,62100000,61770000,330000
2022-05-01,Ang Thong ,central,0.29359999999999997,6500,57871,57871,0,54830000,54830000,0
2022-05-01,Nonthaburi ,central,0.3972,55240,186993,180719,6274,233740000,225570000,8170000
2022-05-01,Pathum Thani ,central,0.2563,22181,92402,91078,1324,117720000,116060000,1660000
2022-05-01,Samut Prakan ,central,0.2593,44887,150248,116421,33827,212670000,169120000,43550000
2022-05-01,Samut Sakhon ,central,0.2339,16984,40296,40176,120,56280000,56050000,230000
2022-05-01,Chachoengsao ,east,0.2985,22228,337047,336782,265,375380000,375140000,240000
2022-05-01,Ratchaburi ,central,0.5282,68095,133696,132778,918,153240000,150620000,2620000
2022-05-01,Kanchanaburi ,central,0.5677,225589,928757,924612,4145,1709980000,1696160000,13820000
2022-05-01,Samut Songkhram ,central,0.45630000000000004,57303,331969,330832,1137,342090000,339920000,2170000
2022-05-01,Suphan Buri ,central,0.4947,58327,290576,290114,462,354960000,354290000,670000
2022-05-01,Phetchaburi ,central,0.6297,307709,752017,749348,2669,2070720000,2061200000,9520000
2022-05-01,Prachuap Khiri Khan ,central,0.5783,376515,753670,746038,7632,2568930000,2495430000,73500000
2022-05-01,Chonburi ,east,0.4581,657093,1024264,967234,57030,6385720000,5609660000,776060000
2022-05-01,Chanthaburi ,east,0.5538000000000001,84917,123514,122861,653,406630000,405220000,1410000
2022-05-01,Trat ,east,0.496,107199,112164,110263,1901,739660000,729330000,10330000
2022-05-01,Nakhon Nayok ,east,0.5132,74370,119268,119179,89,269880000,269640000,240000
2022-05-01,Prachinburi ,east,0.3264,48582,82601,82415,186,220260000,219550000,710000
2022-05-01,Rayong ,east,0.4902,144903,196261,191093,5168,674070000,658400000,15670000
2022-05-01,Sa Kaeo ,east,0.41450000000000004,35217,94984,94495,489,291860000,290730000,1130000
2022-05-01,Phuket ,south,0.3762,299970,346773,164504,182269,11751690000,1239430000,10512260000
2022-05-01,Phatthalung ,south,0.4031,28268,52622,52583,39,65150000,65130000,20000
2022-05-01,Trang ,south,0.4238,56713,81822,81390,432,317620000,316140000,1480000
2022-05-01,Ranong ,south,0.3821,27915,37314,36904,410,93140000,91870000,1270000
2022-05-01,Chumphon ,south,0.41340000000000005,67244,83567,83463,104,255950000,255660000,290000
2022-05-01,Pattani ,south,0.2953,13182,17016,16951,65,42880000,42840000,40000
2022-05-01,Yala ,south,0.5268999999999999,59434,72810,72164,646,143440000,141630000,1810000
2022-05-01,Nakhon Si Thammarat ,south,0.4004,105475,160032,159907,125,468420000,468010000,410000
2022-05-01,Narathiwat ,south,0.2586,19110,22998,22651,347,46010000,44960000,1050000
2022-05-01,Krabi ,south,0.2783,83762,139735,120525,19210,1352410000,1225240000,127170000
2022-05-01,Songkhla ,south,0.3045,111926,177221,136623,40598,1058100000,783230000,274870000
2022-05-01,Phang Nga ,south,0.3565,45279,113946,81547,32399,527820000,263690000,264130000
2022-05-01,Surat Thani ,south,0.4218,209989,272694,222537,50157,2087330000,1439670000,647660000
2022-05-01,Satun ,south,0.5332,73884,139500,138500,1000,540710000,536580000,4130000
2022-05-01,Kamphaeng Phet ,north,0.2803,27456,67769,67106,663,107210000,105960000,1250000
2022-05-01,Chiang Rai ,north,0.5733,261119,346587,341026,5561,2179930000,2121010000,58920000
2022-05-01,Chiang Mai ,north,0.4082,380699,598024,577719,20305,3780670000,3622580000,158090000
2022-05-01,Phichit ,north,0.4093,26690,57107,57051,56,86880000,86750000,130000
2022-05-01,Nakhon Sawan ,north,0.39759999999999995,64904,137944,137071,873,316900000,314090000,2810000
2022-05-01,Tak ,north,0.3889,89007,115138,114974,164,318980000,318320000,660000
2022-05-01,Phitsanulok ,north,0.39649999999999996,106424,194110,192343,1767,455470000,450810000,4660000
2022-05-01,Phayao ,north,0.5832,34331,78735,76506,2229,145430000,139860000,5570000
2022-05-01,Phetchabun ,north,0.3488,118838,160759,158722,2037,476270000,470130000,6140000
2022-05-01,Phrae ,north,0.5607,35984,92109,91441,668,181500000,180050000,1450000
2022-05-01,Lampang ,north,0.4468,39017,113406,112875,531,287680000,285510000,2170000
2022-05-01,Lamphun ,north,0.5019,17488,101460,99920,1540,116670000,113710000,2960000
2022-05-01,Mae Hong Son ,north,0.3778,66746,78753,73358,5395,304060000,276490000,27570000
2022-05-01,Uttaradit ,north,0.3569,36261,73326,73105,221,93140000,92670000,470000
2022-05-01,Uthai Thani ,north,0.3482,21454,76769,76769,0,104360000,104360000,0
2022-05-01,Sukhothai ,north,0.2553,35899,63304,61570,1734,131900000,127340000,4560000
2022-05-01,Nan ,north,0.672,72536,105629,104172,1457,233060000,225960000,7100000
2022-05-01,Kalasin ,east_northeast,0.38770000000000004,17898,50524,50376,148,49620000,49080000,540000
2022-05-01,Khon Kaen ,east_northeast,0.5002,138280,284363,282711,1652,770050000,764980000,5070000
2022-05-01,Chaiyaphum ,east_northeast,0.32549999999999996,44753,83662,83478,184,115890000,115540000,350000
2022-05-01,Nakhon Phanom ,east_northeast,0.6042000000000001,42937,107158,106273,885,145270000,143090000,2180000
2022-05-01,Nakhon Ratchasima ,east_northeast,0.4855,289465,479676,476124,3552,758600000,747940000,10660000
2022-05-01,Buriram ,east_northeast,0.5735,109177,214300,213614,686,436960000,435460000,1500000
2022-05-01,Maha Sarakham ,east_northeast,0.46840000000000004,21232,36484,36170,314,42690000,41810000,880000
2022-05-01,Mukdahan ,east_northeast,0.4515,34874,129581,128511,1070,178480000,175600000,2880000
2022-05-01,Roi Et ,east_northeast,0.2992,20923,49485,49233,252,63330000,62660000,670000
2022-05-01,Loei ,east_northeast,0.5028,83305,139967,139308,659,259160000,257080000,2080000
2022-05-01,Sisaket ,south,0.4103,24776,73291,73210,81,80090000,79910000,180000
2022-05-01,Surin ,east_northeast,0.332,44762,60760,60535,225,108710000,108220000,490000
2022-05-01,Nong Khai ,east_northeast,0.4851,61879,146484,144687,1797,214960000,211110000,3850000
2022-05-01,Bueng Kan ,east_northeast,0.4251,27048,53134,52732,402,65940000,65100000,840000
2022-05-01,Udon Thani ,east_northeast,0.4829,107761,259120,257929,1191,497010000,493140000,3870000
2022-05-01,Ubon Ratchathani ,east_northeast,0.374,75163,169578,169320,258,239580000,238950000,630000
2022-05-01,Sakon Nakhon ,east_northeast,0.397,40056,113960,113572,388,152250000,151150000,1100000
2022-05-01,Yasothon ,east_northeast,0.42210000000000003,10856,42300,42234,66,42990000,42860000,130000
2022-05-01,Amnat Charoen ,east_northeast,0.3193,5708,18130,18081,49,19550000,19440000,110000
2022-05-01,Nong Bua Lamphu ,east_northeast,0.2969,6665,21217,21172,45,16110000,16070000,40000
2022-06-01,Bangkok,central,0.42219999999999996,1268316,2956883,2252527,704356,25556530000,11306830000,14249700000
2022-06-01,Lopburi ,central,0.46130000000000004,56276,368811,368524,287,412000000,411620000,380000
2022-06-01,Phra Nakhon Si Ayutthaya ,central,0.5324,74459,645250,638737,6513,981170000,965750000,15420000
2022-06-01,Saraburi ,central,0.42869999999999997,67682,320809,320378,431,495060000,494440000,620000
2022-06-01,Chainat ,central,0.3874,14086,63327,63230,97,78820000,78740000,80000
2022-06-01,Nakhon Pathom ,central,0.4014,60224,212843,212494,349,282150000,281260000,890000
2022-06-01,Sing Buri ,central,0.36619999999999997,12506,46650,46441,209,57780000,57370000,410000
2022-06-01,Ang Thong ,central,0.2863,6121,54735,54703,32,52370000,52330000,40000
2022-06-01,Nonthaburi ,central,0.4029,55438,181923,173956,7967,233690000,223240000,10450000
2022-06-01,Pathum Thani ,central,0.2691,23024,99129,97380,1749,125070000,122900000,2170000
2022-06-01,Samut Prakan ,central,0.2887,47765,158943,119888,39055,228170000,177870000,50300000
2022-06-01,Samut Sakhon ,central,0.2053,15908,36854,36703,151,51750000,51460000,290000
2022-06-01,Chachoengsao ,east,0.2848,21696,335502,335160,342,370920000,370610000,310000
2022-06-01,Ratchaburi ,central,0.4927,61538,120935,119676,1259,139460000,135600000,3860000
2022-06-01,Kanchanaburi ,central,0.5477000000000001,210309,886654,881886,4768,1620560000,1604440000,16120000
2022-06-01,Samut Songkhram ,central,0.43520000000000003,52808,347849,346171,1678,343940000,340550000,3390000
2022-06-01,Suphan Buri ,central,0.4526,54895,276740,275747,993,334120000,332570000,1550000
2022-06-01,Phetchaburi ,central,0.5889,277959,688227,684823,3404,1877730000,1864440000,13290000
2022-06-01,Prachuap Khiri Khan ,central,0.5742,362131,733336,724690,8646,2493490000,2409850000,83640000
2022-06-01,Chonburi ,east,0.48229999999999995,681783,1061297,971266,90031,6809720000,5660210000,1149510000
2022-06-01,Chanthaburi ,east,0.5286,79194,115561,114851,710,387900000,386360000,1540000
2022-06-01,Trat ,east,0.42,104205,109218,107437,1781,721080000,711140000,9940000
2022-06-01,Nakhon Nayok ,east,0.5439,79327,120317,120182,135,273030000,272650000,380000
2022-06-01,Prachinburi ,east,0.34020000000000006,50454,85479,85276,203,228500000,227730000,770000
2022-06-01,Rayong ,east,0.5387,151195,199283,193727,5556,697690000,680160000,17530000
2022-06-01,Sa Kaeo ,east,0.4456,36517,97515,96942,573,301530000,300210000,1320000
2022-06-01,Phuket ,south,0.46840000000000004,356119,408169,172143,236026,14985550000,1285430000,13700120000
2022-06-01,Phatthalung ,south,0.4097,28714,53193,53110,83,63320000,63280000,40000
2022-06-01,Trang ,south,0.3395,50178,72638,72322,316,281450000,280380000,1070000
2022-06-01,Ranong ,south,0.4012,29011,39322,38757,565,96040000,94330000,1710000
2022-06-01,Chumphon ,south,0.43479999999999996,70522,88498,88247,251,262510000,261820000,690000
2022-06-01,Pattani ,south,0.3134,13692,17827,17705,122,43570000,43500000,70000
2022-06-01,Yala ,south,0.5536,62602,76955,75979,976,148180000,145490000,2690000
2022-06-01,Nakhon Si Thammarat ,south,0.3725,100520,153592,153364,228,438800000,438060000,740000
2022-06-01,Narathiwat ,south,0.2717,19730,23878,23397,481,46590000,45170000,1420000
2022-06-01,Krabi ,south,0.20629999999999998,75119,126414,104915,21499,1216000000,1073190000,142810000
2022-06-01,Songkhla ,south,0.3547,127186,207754,153881,53873,1252880000,889210000,363670000
2022-06-01,Phang Nga ,south,0.28800000000000003,41496,100638,71893,28745,462060000,225890000,236170000
2022-06-01,Surat Thani ,south,0.4461,220354,290943,231352,59591,2200080000,1460690000,739390000
2022-06-01,Satun ,south,0.46619999999999995,66935,129183,127857,1326,486870000,481530000,5340000
2022-06-01,Kamphaeng Phet ,north,0.2395,23648,66676,65728,948,109300000,107580000,1720000
2022-06-01,Chiang Rai ,north,0.5771999999999999,259947,351356,343302,8054,2248720000,2162990000,85730000
2022-06-01,Chiang Mai ,north,0.42450000000000004,379649,582417,555579,26838,3756870000,3543250000,213620000
2022-06-01,Phichit ,north,0.3856,24953,53246,53184,62,81390000,81250000,140000
2022-06-01,Nakhon Sawan ,north,0.4165,67948,149540,148591,949,345820000,342740000,3080000
2022-06-01,Tak ,north,0.3957,90321,118776,118555,221,332090000,331180000,910000
2022-06-01,Phitsanulok ,north,0.38539999999999996,104996,190118,188158,1960,449280000,444040000,5240000
2022-06-01,Phayao ,north,0.5405,32017,72419,69944,2475,135390000,129160000,6230000
2022-06-01,Phetchabun ,north,0.35090000000000005,120129,160597,158086,2511,476800000,469180000,7620000
2022-06-01,Phrae ,north,0.6111,38977,102761,101971,790,204140000,202410000,1730000
2022-06-01,Lampang ,north,0.4667,39953,118521,117841,680,308910000,306080000,2830000
2022-06-01,Lamphun ,north,0.48979999999999996,16957,91718,90261,1457,105010000,102160000,2850000
2022-06-01,Mae Hong Son ,north,0.43579999999999997,72767,86138,79557,6581,336900000,302910000,33990000
2022-06-01,Uttaradit ,north,0.39159999999999995,38526,74193,73896,297,95470000,94830000,640000
2022-06-01,Uthai Thani ,north,0.3667,22016,75579,75579,0,103210000,103210000,0
2022-06-01,Sukhothai ,north,0.2504,35808,62768,60298,2470,131860000,125490000,6370000
2022-06-01,Nan ,north,0.6168,68114,97496,96244,1252,214120000,207870000,6250000
2022-06-01,Kalasin ,east_northeast,0.40630000000000005,18318,51546,51245,301,50980000,49830000,1150000
2022-06-01,Khon Kaen ,east_northeast,0.4927,133491,273287,271105,2182,745560000,738690000,6870000
2022-06-01,Chaiyaphum ,east_northeast,0.35340000000000005,46029,85540,85219,321,120200000,119480000,720000
2022-06-01,Nakhon Phanom ,east_northeast,0.6218,43528,108919,107587,1332,152560000,149240000,3320000
2022-06-01,Nakhon Ratchasima ,east_northeast,0.48200000000000004,289093,478454,473498,4956,760010000,743830000,16180000
2022-06-01,Buriram ,east_northeast,0.563,106802,209622,208602,1020,420600000,418510000,2090000
2022-06-01,Maha Sarakham ,east_northeast,0.4556,20744,35591,35037,554,41880000,40450000,1430000
2022-06-01,Mukdahan ,east_northeast,0.4326,33637,125408,123864,1544,172900000,169010000,3890000
2022-06-01,Roi Et ,east_northeast,0.2975,20009,48038,47652,386,61300000,60230000,1070000
2022-06-01,Loei ,east_northeast,0.47490000000000004,81240,132773,132036,737,250560000,248220000,2340000
2022-06-01,Sisaket ,south,0.4201,25818,75698,75522,176,88000000,87590000,410000
2022-06-01,Surin ,east_northeast,0.3232,43800,59502,59196,306,106470000,105800000,670000
2022-06-01,Nong Khai ,east_northeast,0.49520000000000003,63575,182362,146348,36014,295290000,213670000,81620000
2022-06-01,Bueng Kan ,east_northeast,0.43700000000000006,27526,54086,53504,582,68470000,67220000,1250000
2022-06-01,Udon Thani ,east_northeast,0.4763,103845,268696,249130,19566,539910000,474600000,65310000
2022-06-01,Ubon Ratchathani ,east_northeast,0.39020000000000005,76581,172689,172207,482,244260000,243040000,1220000
2022-06-01,Sakon Nakhon ,east_northeast,0.41590000000000005,41370,116340,115794,546,156560000,155000000,1560000
2022-06-01,Yasothon ,east_northeast,0.38520000000000004,10085,38229,38094,135,38340000,38100000,240000
2022-06-01,Amnat Charoen ,east_northeast,0.3063,5252,16696,16587,109,18030000,17780000,250000
2022-06-01,Nong Bua Lamphu ,east_northeast,0.3151,7033,22310,22229,81,16990000,16900000,90000
2022-07-01,Bangkok,central,0.49079999999999996,1415912,3322469,2319693,1002776,32058420000,11952560000,20105860000
2022-07-01,Lopburi ,central,0.479,58976,378652,378041,611,424090000,423300000,790000
2022-07-01,Phra Nakhon Si Ayutthaya ,central,0.5745,79559,675696,659004,16692,1029740000,990630000,39110000
2022-07-01,Saraburi ,central,0.4976,76413,354048,353222,826,548010000,546830000,1180000
2022-07-01,Chainat ,central,0.42469999999999997,15163,70706,70513,193,87350000,87200000,150000
2022-07-01,Nakhon Pathom ,central,0.44189999999999996,64818,287049,286146,903,331870000,329600000,2270000
2022-07-01,Sing Buri ,central,0.41450000000000004,14445,54084,53749,335,66550000,65890000,660000
2022-07-01,Ang Thong ,central,0.39280000000000004,7901,74890,74812,78,70830000,70730000,100000
2022-07-01,Nonthaburi ,central,0.4551,63452,235519,227534,7985,295420000,284830000,10590000
2022-07-01,Pathum Thani ,central,0.2938,25006,114313,112539,1774,142730000,140520000,2210000
2022-07-01,Samut Prakan ,central,0.33340000000000003,52160,170775,127998,42777,246980000,191910000,55070000
2022-07-01,Samut Sakhon ,central,0.2432,16895,38455,38230,225,54320000,53890000,430000
2022-07-01,Chachoengsao ,east,0.3093,22985,411053,410661,392,437570000,437210000,360000
2022-07-01,Ratchaburi ,central,0.5086999999999999,64292,132533,131027,1506,153840000,149290000,4550000
2022-07-01,Kanchanaburi ,central,0.601,233019,944805,937426,7379,1756560000,1731660000,24900000
2022-07-01,Samut Songkhram ,central,0.46340000000000003,58590,363477,361579,1898,366570000,362820000,3750000
2022-07-01,Suphan Buri ,central,0.4833,60397,293034,291952,1082,350630000,348980000,1650000
2022-07-01,Phetchaburi ,central,0.6015,289681,717337,712158,5179,1933800000,1912120000,21680000
2022-07-01,Prachuap Khiri Khan ,central,0.5847,377599,756385,746223,10162,2587150000,2487650000,99500000
2022-07-01,Chonburi ,east,0.5597,743082,1142238,1021745,120493,7620960000,5931000000,1689960000
2022-07-01,Chanthaburi ,east,0.5133,78170,114128,113293,835,382110000,380280000,1830000
2022-07-01,Trat ,east,0.4191,103396,107881,105177,2704,710650000,695050000,15600000
2022-07-01,Nakhon Nayok ,east,0.5807,82379,124970,124759,211,281650000,281060000,590000
2022-07-01,Prachinburi ,east,0.3736,53238,87208,86985,223,232680000,231830000,850000
2022-07-01,Rayong ,east,0.5559000000000001,154473,205537,196830,8707,712960000,687810000,25150000
2022-07-01,Sa Kaeo ,east,0.4764,38173,101004,100387,617,318140000,316700000,1440000
2022-07-01,Phuket ,south,0.5307,478012,545201,180043,365158,21668180000,1354960000,20313220000
2022-07-01,Phatthalung ,south,0.4524,30974,56351,56176,175,66150000,66070000,80000
2022-07-01,Trang ,south,0.38280000000000003,54003,79774,79278,496,289700000,288100000,1600000
2022-07-01,Ranong ,south,0.4363,30968,45280,44452,828,107460000,105020000,2440000
2022-07-01,Chumphon ,south,0.47590000000000005,76297,99307,98749,558,285310000,283800000,1510000
2022-07-01,Pattani ,south,0.38530000000000003,15168,23541,22054,1487,51060000,50370000,690000
2022-07-01,Yala ,south,0.6244,69709,94534,80978,13556,187950000,150910000,37040000
2022-07-01,Nakhon Si Thammarat ,south,0.4071,107327,168009,167522,487,463930000,462410000,1520000
2022-07-01,Narathiwat ,south,0.3347,21614,31538,26097,5441,64560000,48740000,15820000
2022-07-01,Krabi ,south,0.2351,79890,137504,109745,27759,1262230000,1086600000,175630000
2022-07-01,Songkhla ,south,0.433,141431,242816,175287,67529,1384470000,948770000,435700000
2022-07-01,Phang Nga ,south,0.2622,39116,93719,67228,26491,408120000,204700000,203420000
2022-07-01,Surat Thani ,south,0.5047999999999999,240813,325199,251402,73797,2399100000,1520030000,879070000
2022-07-01,Satun ,south,0.5045000000000001,71438,140571,137612,2959,513920000,502140000,11780000
2022-07-01,Kamphaeng Phet ,north,0.3028,25948,70190,68916,1274,116210000,113860000,2350000
2022-07-01,Chiang Rai ,north,0.5986,270043,381708,365046,16662,2505620000,2327350000,178270000
2022-07-01,Chiang Mai ,north,0.4512,400473,623658,574357,49301,4091020000,3692970000,398050000
2022-07-01,Phichit ,north,0.4482,27109,58148,58044,104,89660000,89430000,230000
2022-07-01,Nakhon Sawan ,north,0.4653,73314,160654,159690,964,373150000,369990000,3160000
2022-07-01,Tak ,north,0.4539,98178,129748,129402,346,366890000,365440000,1450000
2022-07-01,Phitsanulok ,north,0.45130000000000003,115351,212892,210094,2798,507210000,499680000,7530000
2022-07-01,Phayao ,north,0.5483,32639,75879,72830,3049,143690000,135940000,7750000
2022-07-01,Phetchabun ,north,0.4378,132663,176755,173137,3618,531320000,520120000,11200000
2022-07-01,Phrae ,north,0.6153,39699,106620,105824,796,213570000,211800000,1770000
2022-07-01,Lampang ,north,0.5386,43936,132178,130996,1182,349980000,345010000,4970000
2022-07-01,Lamphun ,north,0.5074000000000001,17586,95180,92919,2261,110610000,106150000,4460000
2022-07-01,Mae Hong Son ,north,0.45189999999999997,75013,89522,81284,8238,355820000,312720000,43100000
2022-07-01,Uttaradit ,north,0.42579999999999996,40738,80901,80532,369,104890000,104090000,800000
2022-07-01,Uthai Thani ,north,0.43810000000000004,24235,85814,85776,38,118060000,117980000,80000
2022-07-01,Sukhothai ,north,0.33649999999999997,39699,78173,69150,9023,168610000,145020000,23590000
2022-07-01,Nan ,north,0.6204,68965,100013,98804,1209,223620000,217570000,6050000
2022-07-01,Kalasin ,east_northeast,0.4286,19048,53565,52989,576,56010000,53760000,2250000
2022-07-01,Khon Kaen ,east_northeast,0.517,137498,286036,282594,3442,833270000,821650000,11620000
2022-07-01,Chaiyaphum ,east_northeast,0.3874,48086,88751,88246,505,125630000,124400000,1230000
2022-07-01,Nakhon Phanom ,east_northeast,0.6620999999999999,55069,143618,135929,7689,211420000,193580000,17840000
2022-07-01,Nakhon Ratchasima ,east_northeast,0.5294,306700,514615,503571,11044,872200000,834470000,37730000
2022-07-01,Buriram ,east_northeast,0.6069,111263,218778,217215,1563,439510000,435900000,3610000
2022-07-01,Maha Sarakham ,east_northeast,0.48229999999999995,21371,38721,37999,722,47370000,45360000,2010000
2022-07-01,Mukdahan ,east_northeast,0.4556,34226,135318,127690,7628,190940000,172310000,18630000
2022-07-01,Roi Et ,east_northeast,0.3178,20445,47766,47144,622,59920000,58570000,1350000
2022-07-01,Loei ,east_northeast,0.5161,86338,141380,140451,929,271080000,268030000,3050000
2022-07-01,Sisaket ,south,0.45640000000000003,26858,79202,78837,365,95120000,94150000,970000
2022-07-01,Surin ,east_northeast,0.35340000000000005,45934,61313,60914,399,109910000,108990000,920000
2022-07-01,Nong Khai ,east_northeast,0.5296,67341,196578,152673,43905,328340000,228180000,100160000
2022-07-01,Bueng Kan ,east_northeast,0.47909999999999997,29027,57515,55701,1814,77020000,74340000,2680000
2022-07-01,Udon Thani ,east_northeast,0.5217,110081,299046,276936,22110,580490000,506200000,74290000
2022-07-01,Ubon Ratchathani ,east_northeast,0.4236,79539,178251,177251,1000,255400000,252800000,2600000
2022-07-01,Sakon Nakhon ,east_northeast,0.48869999999999997,46404,128451,127618,833,179710000,177260000,2450000
2022-07-01,Yasothon ,east_northeast,0.3987,10430,39065,38894,171,39860000,39540000,320000
2022-07-01,Amnat Charoen ,east_northeast,0.33340000000000003,5473,17393,17207,186,19900000,19380000,520000
2022-07-01,Nong Bua Lamphu ,east_northeast,0.3435,7245,22743,22632,111,18270000,18140000,130000
2022-08-01,Bangkok,central,0.5239,1499278,3516020,2468413,1047607,33665040000,12625600000,21039440000
2022-08-01,Lopburi ,central,0.45840000000000003,56168,346222,345655,567,392420000,391670000,750000
2022-08-01,Phra Nakhon Si Ayutthaya ,central,0.5929,83266,736877,706126,30751,1115800000,1045160000,70640000
2022-08-01,Saraburi ,central,0.4824,74072,339457,338312,1145,512200000,510530000,1670000
2022-08-01,Chainat ,central,0.3968,14215,65541,65403,138,81290000,81180000,110000
2022-08-01,Nakhon Pathom ,central,0.4131,60729,230789,229276,1513,274030000,270300000,3730000
2022-08-01,Sing Buri ,central,0.38270000000000004,13524,50782,50418,364,63360000,62640000,720000
2022-08-01,Ang Thong ,central,0.32659999999999995,6964,49364,49302,62,50110000,50020000,90000
2022-08-01,Nonthaburi ,central,0.47240000000000004,65632,244847,235754,9093,309330000,297080000,12250000
2022-08-01,Pathum Thani ,central,0.2775,24130,138940,136216,2724,176800000,173450000,3350000
2022-08-01,Samut Prakan ,central,0.3492,54777,212700,171020,41680,301440000,246730000,54710000
2022-08-01,Samut Sakhon ,central,0.2217,16038,35456,35263,193,49790000,49420000,370000
2022-08-01,Chachoengsao ,east,0.2904,21770,397602,397149,453,421180000,420770000,410000
2022-08-01,Ratchaburi ,central,0.4731,58986,117977,116151,1826,140210000,134530000,5680000
2022-08-01,Kanchanaburi ,central,0.5699000000000001,218875,900997,893329,7668,1667070000,1641100000,25970000
2022-08-01,Samut Songkhram ,central,0.428,54258,351950,349859,2091,350520000,346180000,4340000
2022-08-01,Suphan Buri ,central,0.4388,58993,287947,286823,1124,343000000,341320000,1680000
2022-08-01,Phetchaburi ,central,0.5858,271005,718037,712637,5400,1856540000,1834520000,22020000
2022-08-01,Prachuap Khiri Khan ,central,0.5672,365661,789418,778982,10436,2568890000,2466680000,102210000
2022-08-01,Chonburi ,east,0.578,765009,1187655,1034326,153329,8077610000,5993500000,2084110000
2022-08-01,Chanthaburi ,east,0.504,77443,113083,112163,920,379320000,377300000,2020000
2022-08-01,Trat ,east,0.3583,97274,101677,99243,2434,670060000,656030000,14030000
2022-08-01,Nakhon Nayok ,east,0.5982999999999999,83586,126807,126647,160,285770000,285320000,450000
2022-08-01,Prachinburi ,east,0.31679999999999997,50445,81408,81205,203,217590000,216810000,780000
2022-08-01,Rayong ,east,0.6011,161685,215539,205655,9884,747320000,718730000,28590000
2022-08-01,Sa Kaeo ,east,0.46490000000000004,37255,99772,99141,631,314210000,312740000,1470000
2022-08-01,Phuket ,south,0.5371,491856,567163,186435,380728,21986730000,1366280000,20620450000
2022-08-01,Phatthalung ,south,0.4886,32934,61341,61039,302,69800000,69670000,130000
2022-08-01,Trang ,south,0.40380000000000005,56566,84706,83893,813,297840000,295270000,2570000
2022-08-01,Ranong ,south,0.3951,28685,41585,40941,644,95660000,93850000,1810000
2022-08-01,Chumphon ,south,0.442,71426,92041,91633,408,255290000,254230000,1060000
2022-08-01,Pattani ,south,0.37060000000000004,14708,22400,20508,1892,46290000,45430000,860000
2022-08-01,Yala ,south,0.6126,67464,93510,76739,16771,182740000,138250000,44490000
2022-08-01,Nakhon Si Thammarat ,south,0.45299999999999996,115182,180253,179456,797,484810000,482370000,2440000
2022-08-01,Narathiwat ,south,0.3292,21767,32695,25048,7647,67400000,45710000,21690000
2022-08-01,Krabi ,south,0.2072,75398,131288,106495,24793,1153060000,1001630000,151430000
2022-08-01,Songkhla ,south,0.4547,148821,269552,163294,106258,1522790000,868730000,654060000
2022-08-01,Phang Nga ,south,0.3248,42875,104794,72990,31804,453850000,215220000,238630000
2022-08-01,Surat Thani ,south,0.5431,257133,360106,266134,93972,3151260000,1831480000,1319780000
2022-08-01,Satun ,south,0.4667,66677,131403,128426,2977,465050000,453560000,11490000
2022-08-01,Kamphaeng Phet ,north,0.29059999999999997,25809,60520,58884,1636,102420000,99390000,3030000
2022-08-01,Chiang Rai ,north,0.5564,262558,375288,353508,21780,2510440000,2277840000,232600000
2022-08-01,Chiang Mai ,north,0.4756,418941,631430,560795,70635,4229870000,3645680000,584190000
2022-08-01,Phichit ,north,0.4551,27498,61549,61466,83,95870000,95680000,190000
2022-08-01,Nakhon Sawan ,north,0.45289999999999997,72863,152753,152058,695,362110000,359790000,2320000
2022-08-01,Tak ,north,0.4793,102090,135123,134570,553,388590000,386260000,2330000
2022-08-01,Phitsanulok ,north,0.44520000000000004,114899,210194,206258,3936,506070000,495360000,10710000
2022-08-01,Phayao ,north,0.532,32293,73931,70349,3582,141260000,132100000,9160000
2022-08-01,Phetchabun ,north,0.4561,136852,179267,175080,4187,546070000,532840000,13230000
2022-08-01,Phrae ,north,0.5728,38523,101038,100296,742,204250000,202580000,1670000
2022-08-01,Lampang ,north,0.5265,43573,127309,125637,1672,344730000,337660000,7070000
2022-08-01,Lamphun ,north,0.4987,17518,93389,91622,1767,109240000,105680000,3560000
2022-08-01,Mae Hong Son ,north,0.3954,70601,83727,76117,7610,338010000,297330000,40680000
2022-08-01,Uttaradit ,north,0.41259999999999997,40402,77901,77497,404,103280000,102390000,890000
2022-08-01,Uthai Thani ,north,0.4254,24023,82070,82037,33,114250000,114180000,70000
2022-08-01,Sukhothai ,north,0.3046,39210,78503,67628,10875,171210000,143270000,27940000
2022-08-01,Nan ,north,0.5972999999999999,67984,98733,97708,1025,221820000,216630000,5190000
2022-08-01,Kalasin ,east_northeast,0.44909999999999994,19821,55437,54839,598,59410000,57070000,2340000
2022-08-01,Khon Kaen ,east_northeast,0.536,142631,297377,293857,3520,857910000,845980000,11930000
2022-08-01,Chaiyaphum ,east_northeast,0.3567,44428,78211,77739,472,108330000,107190000,1140000
2022-08-01,Nakhon Phanom ,east_northeast,0.6823,56392,146804,138897,7907,219460000,200790000,18670000
2022-08-01,Nakhon Ratchasima ,east_northeast,0.5012,290940,481938,472597,9341,812560000,782930000,29630000
2022-08-01,Buriram ,east_northeast,0.5951,109146,215926,214412,1514,418630000,415080000,3550000
2022-08-01,Maha Sarakham ,east_northeast,0.5186999999999999,22773,43376,42378,998,53090000,50330000,2760000
2022-08-01,Mukdahan ,east_northeast,0.46909999999999996,35092,140040,130444,9596,199120000,177140000,21980000
2022-08-01,Roi Et ,east_northeast,0.3465,22099,50778,50185,593,64280000,63030000,1250000
2022-08-01,Loei ,east_northeast,0.5206000000000001,86649,142290,141394,896,272500000,269500000,3000000
2022-08-01,Sisaket ,south,0.4372,25774,75180,74812,368,89360000,88420000,940000
2022-08-01,Surin ,east_northeast,0.3358,44959,60040,59665,375,105390000,104540000,850000
2022-08-01,Nong Khai ,east_northeast,0.5091,65489,197911,149379,48532,328170000,217620000,110550000
2022-08-01,Bueng Kan ,east_northeast,0.4935,29857,58922,57036,1886,78140000,75280000,2860000
2022-08-01,Udon Thani ,east_northeast,0.5051,106666,280401,257774,22627,529760000,453420000,76340000
2022-08-01,Ubon Ratchathani ,east_northeast,0.4054,76761,173758,172785,973,241800000,239340000,2460000
2022-08-01,Sakon Nakhon ,east_northeast,0.5003,47577,130758,129946,812,187230000,184890000,2340000
2022-08-01,Yasothon ,east_northeast,0.3701,10025,37789,37646,143,38380000,38130000,250000
2022-08-01,Amnat Charoen ,east_northeast,0.3189,5412,17253,17090,163,19040000,18620000,420000
2022-08-01,Nong Bua Lamphu ,east_northeast,0.326,7219,22685,22604,81,18030000,17940000,90000
2022-09-01,Bangkok,central,0.5519,1589796,3501068,2495479,1005589,33360290000,12973920000,20386370000
2022-09-01,Lopburi ,central,0.4057,51028,319656,319139,517,368990000,368290000,700000
2022-09-01,Phra Nakhon Si Ayutthaya ,central,0.465,69577,667293,639034,28259,1029500000,962480000,67020000
2022-09-01,Saraburi ,central,0.3799,60746,303156,301982,1174,468280000,466550000,1730000
2022-09-01,Chainat ,central,0.4241,15162,70276,70117,159,90010000,89880000,130000
2022-09-01,Nakhon Pathom ,central,0.6172,90952,321855,320177,1678,389360000,385170000,4190000
2022-09-01,Sing Buri ,central,0.3325,11813,46961,46682,279,59940000,59370000,570000
2022-09-01,Ang Thong ,central,0.294,6375,46060,45996,64,47960000,47870000,90000
2022-09-01,Nonthaburi ,central,0.4579,63222,250653,241462,9191,317110000,304610000,12500000
2022-09-01,Pathum Thani ,central,0.2583,23153,131311,128307,3004,169870000,166100000,3770000
2022-09-01,Samut Prakan ,central,0.3375,52990,207476,164533,42943,298680000,240330000,58350000
2022-09-01,Samut Sakhon ,central,0.21280000000000002,15617,37932,37707,225,50650000,50210000,440000
2022-09-01,Chachoengsao ,east,0.2756,21108,390025,389560,465,423630000,423200000,430000
2022-09-01,Ratchaburi ,central,0.49670000000000003,61015,123400,121334,2066,145930000,139670000,6260000
2022-09-01,Kanchanaburi ,central,0.5755,229786,933871,925607,8264,1735570000,1707390000,28180000
2022-09-01,Samut Songkhram ,central,0.4476,56982,379142,376884,2258,375090000,369900000,5190000
2022-09-01,Suphan Buri ,central,0.4536,61061,305215,303803,1412,358010000,355870000,2140000
2022-09-01,Phetchaburi ,central,0.6051,278130,749178,742941,6237,1918760000,1893180000,25580000
2022-09-01,Prachuap Khiri Khan ,central,0.6041,386178,843506,832166,11340,2784950000,2674640000,110310000
2022-09-01,Chonburi ,east,0.5768,716099,1083365,938336,145029,7338490000,5433310000,1905180000
2022-09-01,Chanthaburi ,east,0.45130000000000003,73494,108316,107575,741,360850000,359230000,1620000
2022-09-01,Trat ,east,0.3012,91665,95432,93660,1772,629450000,619250000,10200000
2022-09-01,Nakhon Nayok ,east,0.6068,84399,128029,127860,169,288530000,288050000,480000
2022-09-01,Prachinburi ,east,0.3328,51222,82394,82219,175,220030000,219360000,670000
2022-09-01,Rayong ,east,0.5931000000000001,160525,208734,203515,5219,723940000,708800000,15140000
2022-09-01,Sa Kaeo ,east,0.4829,37931,101116,100613,503,318750000,317580000,1170000
2022-09-01,Phuket ,south,0.5415,493943,563713,173396,390317,21829400000,1226620000,20602780000
2022-09-01,Phatthalung ,south,0.4631,31155,56789,56404,385,62370000,62210000,160000
2022-09-01,Trang ,south,0.4635,61459,90608,89961,647,310960000,308840000,2120000
2022-09-01,Ranong ,south,0.41859999999999997,29994,44957,44464,493,98510000,97170000,1340000
2022-09-01,Chumphon ,south,0.4838,76248,98240,97959,281,264630000,263930000,700000
2022-09-01,Pattani ,south,0.40259999999999996,15542,25063,22609,2454,49990000,48900000,1090000
2022-09-01,Yala ,south,0.6674,72825,103342,80227,23115,200430000,140370000,60060000
2022-09-01,Nakhon Si Thammarat ,south,0.47590000000000005,120657,189723,189010,713,500480000,498370000,2110000
2022-09-01,Narathiwat ,south,0.4537,25139,41797,27793,14004,87890000,49080000,38810000
2022-09-01,Krabi ,south,0.23309999999999997,79337,137413,114060,23353,1172780000,1034140000,138640000
2022-09-01,Songkhla ,south,0.6043,175875,332660,181061,151599,1849340000,935210000,914130000
2022-09-01,Phang Nga ,south,0.3037,40533,97719,67767,29952,418110000,197560000,220550000
2022-09-01,Surat Thani ,south,0.5212,245309,336348,253501,82847,2838200000,1698960000,1139240000
2022-09-01,Satun ,south,0.4157,61167,122969,119336,3633,419850000,406130000,13720000
2022-09-01,Kamphaeng Phet ,north,0.3251,27207,58743,56749,1994,100640000,96930000,3710000
2022-09-01,Chiang Rai ,north,0.6143,282616,409448,373670,35778,2819210000,2434230000,384980000
2022-09-01,Chiang Mai ,north,0.5168,446430,629097,538212,90885,4475370000,3552690000,922680000
2022-09-01,Phichit ,north,0.4625,28072,59625,59528,97,93570000,93350000,220000
2022-09-01,Nakhon Sawan ,north,0.4457,72069,143196,142477,719,343570000,341150000,2420000
2022-09-01,Tak ,north,0.5209,108652,145619,144259,1360,423280000,417470000,5810000
2022-09-01,Phitsanulok ,north,0.4236,113158,200017,194746,5271,494060000,479610000,14450000
2022-09-01,Phayao ,north,0.5684,34603,72826,68996,3830,141300000,131260000,10040000
2022-09-01,Phetchabun ,north,0.4756,141204,179625,176297,3328,550420000,539560000,10860000
2022-09-01,Phrae ,north,0.5942000000000001,40375,104142,103519,623,214000000,212490000,1510000
2022-09-01,Lampang ,north,0.5381,44994,132077,129548,2529,362000000,351220000,10780000
2022-09-01,Lamphun ,north,0.5063,17805,90637,87765,2872,108630000,102970000,5660000
2022-09-01,Mae Hong Son ,north,0.3589,68666,80341,71992,8349,328560000,283560000,45000000
2022-09-01,Uttaradit ,north,0.39399999999999996,40015,79281,78899,382,106390000,105520000,870000
2022-09-01,Uthai Thani ,north,0.40869999999999995,23819,80237,80209,28,113190000,113130000,60000
2022-09-01,Sukhothai ,north,0.2704,38078,73129,64997,8132,161850000,139500000,22350000
2022-09-01,Nan ,north,0.6358,71969,103527,102629,898,235360000,230670000,4690000
2022-09-01,Kalasin ,east_northeast,0.42969999999999997,19248,54398,53819,579,57310000,55230000,2080000
2022-09-01,Khon Kaen ,east_northeast,0.5161,138431,288230,284857,3373,812930000,801750000,11180000
2022-09-01,Chaiyaphum ,east_northeast,0.3125,42116,74720,74275,445,99480000,98450000,1030000
2022-09-01,Nakhon Phanom ,east_northeast,0.703,58144,151895,144267,7628,228160000,210270000,17890000
2022-09-01,Nakhon Ratchasima ,east_northeast,0.4708,277363,459623,450594,9029,764060000,736000000,28060000
2022-09-01,Buriram ,east_northeast,0.7515000000000001,139388,258487,256030,2457,529460000,522890000,6570000
2022-09-01,Maha Sarakham ,east_northeast,0.5363,23846,48133,47269,864,58230000,55900000,2330000
2022-09-01,Mukdahan ,east_northeast,0.4765,35672,141583,132702,8881,201320000,181320000,20000000
2022-09-01,Roi Et ,east_northeast,0.319,21025,48792,48278,514,60800000,59740000,1060000
2022-09-01,Loei ,east_northeast,0.5329,88856,147724,146757,967,284280000,280960000,3320000
2022-09-01,Sisaket ,south,0.4239,24821,71662,71301,361,84200000,83320000,880000
2022-09-01,Surin ,east_northeast,0.41850000000000004,52303,70605,70179,426,128280000,127300000,980000
2022-09-01,Nong Khai ,east_northeast,0.4989,64333,194858,147673,47185,319010000,211590000,107420000
2022-09-01,Bueng Kan ,east_northeast,0.519,30918,60694,58687,2007,82230000,79180000,3050000
2022-09-01,Udon Thani ,east_northeast,0.49329999999999996,104210,276798,254213,22585,517340000,441330000,76010000
2022-09-01,Ubon Ratchathani ,east_northeast,0.38530000000000003,74944,170777,169895,882,232860000,230700000,2160000
2022-09-01,Sakon Nakhon ,east_northeast,0.6781,76738,194410,193471,939,297360000,294820000,2540000
2022-09-01,Yasothon ,east_northeast,0.35840000000000005,9815,37146,37027,119,36940000,36770000,170000
2022-09-01,Amnat Charoen ,east_northeast,0.3146,5321,17002,16844,158,18540000,18150000,390000
2022-09-01,Nong Bua Lamphu ,east_northeast,0.319,6881,21950,21884,66,17130000,17060000,70000
2022-10-01,Bangkok,central,0.5761,1666579,3679161,2449908,1229253,37915120000,12459390000,25455730000
2022-10-01,Lopburi ,central,0.41700000000000004,52904,294261,293533,728,353390000,352380000,1010000
2022-10-01,Phra Nakhon Si Ayutthaya ,central,0.4436,66149,640931,614477,26454,970420000,908250000,62170000
2022-10-01,Saraburi ,central,0.47159999999999996,72404,339202,337685,1517,532960000,530750000,2210000
2022-10-01,Chainat ,central,0.3969,14203,65661,65430,231,85620000,85430000,190000
2022-10-01,Nakhon Pathom ,central,0.4354,68090,244756,242063,2693,306590000,299950000,6640000
2022-10-01,Sing Buri ,central,0.3518,12503,52086,51597,489,65280000,64300000,980000
2022-10-01,Ang Thong ,central,0.26289999999999997,5839,43532,43491,41,45810000,45750000,60000
2022-10-01,Nonthaburi ,central,0.4372,61082,235644,225429,10215,302580000,288740000,13840000
2022-10-01,Pathum Thani ,central,0.30210000000000004,25269,145181,140499,4682,191100000,185130000,5970000
2022-10-01,Samut Prakan ,central,0.43329999999999996,63348,267541,219737,47804,393630000,326830000,66800000
2022-10-01,Samut Sakhon ,central,0.25120000000000003,16907,45976,45630,346,60170000,59500000,670000
2022-10-01,Chachoengsao ,east,0.3053,22339,394489,393702,787,433440000,432700000,740000
2022-10-01,Ratchaburi ,central,0.5166,65196,136074,129841,6233,167230000,152150000,15080000
2022-10-01,Kanchanaburi ,central,0.5932,243360,985671,973729,11942,1856960000,1814000000,42960000
2022-10-01,Samut Songkhram ,central,0.4508,58110,404620,400887,3733,403590000,397070000,6520000
2022-10-01,Suphan Buri ,central,0.474,63194,314982,312122,2860,421520000,416930000,4590000
2022-10-01,Phetchaburi ,central,0.6376,308030,809274,802066,7208,2300740000,2270380000,30360000
2022-10-01,Prachuap Khiri Khan ,central,0.6693000000000001,456213,909030,885893,23137,3041380000,2814970000,226410000
2022-10-01,Chonburi ,east,0.6077,832270,1310830,1087644,223186,9108620000,6325270000,2783350000
2022-10-01,Chanthaburi ,east,0.4707,74859,115375,114451,924,388150000,386080000,2070000
2022-10-01,Trat ,east,0.4035,101147,115696,110548,5148,760510000,730040000,30470000
2022-10-01,Nakhon Nayok ,east,0.6457999999999999,87735,138965,138729,236,318160000,317480000,680000
2022-10-01,Prachinburi ,east,0.3771,53389,86810,86576,234,230560000,229640000,920000
2022-10-01,Rayong ,east,0.7162000000000001,182640,248816,235941,12875,864430000,826410000,38020000
2022-10-01,Sa Kaeo ,east,0.5034000000000001,38773,105732,104583,1149,333830000,331050000,2780000
2022-10-01,Phuket ,south,0.5642,489390,573197,198488,374709,20363750000,1378190000,18985560000
2022-10-01,Phatthalung ,south,0.48710000000000003,32795,60178,59699,479,64480000,64290000,190000
2022-10-01,Trang ,south,0.503,65233,95901,95028,873,321420000,318610000,2810000
2022-10-01,Ranong ,south,0.4593,32081,48194,47544,650,103260000,101520000,1740000
2022-10-01,Chumphon ,south,0.49810000000000004,78758,101985,101605,380,269720000,268790000,930000
2022-10-01,Pattani ,south,0.426,16374,27198,24466,2732,53230000,52040000,1190000
2022-10-01,Yala ,south,0.7325,79839,115354,85185,30169,224050000,146630000,77420000
2022-10-01,Nakhon Si Thammarat ,south,0.5232,129416,203375,202496,879,526830000,524290000,2540000
2022-10-01,Narathiwat ,south,0.48950000000000005,26837,47623,29600,18023,100110000,51110000,49000000
2022-10-01,Krabi ,south,0.2873,86208,151460,122782,28678,1255900000,1089240000,166660000
2022-10-01,Songkhla ,south,0.5835,168416,323735,164961,158774,1811870000,875180000,936690000
2022-10-01,Phang Nga ,south,0.4048,45911,109325,71901,37424,476750000,206240000,270510000
2022-10-01,Surat Thani ,south,0.5451,257860,365555,268734,96821,2617920000,1554840000,1063080000
2022-10-01,Satun ,south,0.45770000000000005,65671,132895,128076,4819,445980000,428100000,17880000
2022-10-01,Kamphaeng Phet ,north,0.3529,28762,62909,60548,2361,109860000,105390000,4470000
2022-10-01,Chiang Rai ,north,0.6581,303137,442558,398402,44156,3126340000,2641840000,484500000
2022-10-01,Chiang Mai ,north,0.5872999999999999,492496,724904,559781,165123,5152010000,3760150000,1391860000
2022-10-01,Phichit ,north,0.4754,28865,58664,58585,79,93320000,93140000,180000
2022-10-01,Nakhon Sawan ,north,0.4671,75389,157436,156894,542,385230000,383370000,1860000
2022-10-01,Tak ,north,0.5539999999999999,115130,155827,154135,1692,469760000,462420000,7340000
2022-10-01,Phitsanulok ,north,0.45890000000000003,122143,219715,213479,6236,549890000,532470000,17420000
2022-10-01,Phayao ,north,0.6057,36871,81678,77463,4215,161950000,150710000,11240000
2022-10-01,Phetchabun ,north,0.5102,149669,193869,190155,3714,608240000,595940000,12300000
2022-10-01,Phrae ,north,0.6236,43220,108354,107640,714,226060000,224250000,1810000
2022-10-01,Lampang ,north,0.5993999999999999,48709,144793,141684,3109,406670000,393020000,13650000
2022-10-01,Lamphun ,north,0.5669,19313,99584,96399,3185,123170000,116720000,6450000
2022-10-01,Mae Hong Son ,north,0.5072,81206,93547,82310,11237,392060000,330490000,61570000
2022-10-01,Uttaradit ,north,0.4385,42754,85117,84630,487,116900000,115720000,1180000
2022-10-01,Uthai Thani ,north,0.38539999999999996,23460,79095,79072,23,112790000,112740000,50000
2022-10-01,Sukhothai ,north,0.32789999999999997,41114,84108,74050,10058,190210000,161990000,28220000
2022-10-01,Nan ,north,0.7086,79593,116087,115234,853,267960000,263400000,4560000
2022-10-01,Kalasin ,east_northeast,0.43229999999999996,19352,53675,52943,732,55610000,53280000,2330000
2022-10-01,Khon Kaen ,east_northeast,0.5304,146040,308731,301356,7375,844550000,826890000,17660000
2022-10-01,Chaiyaphum ,east_northeast,0.36579999999999996,47589,84058,83689,369,110480000,109660000,820000
2022-10-01,Nakhon Phanom ,east_northeast,0.7576,63103,162974,155081,7893,246530000,227930000,18600000
2022-10-01,Nakhon Ratchasima ,east_northeast,0.5186999999999999,300164,503057,493628,9429,838130000,808620000,29510000
2022-10-01,Buriram ,east_northeast,0.8641,193238,426795,423010,3785,891520000,880840000,10680000
2022-10-01,Maha Sarakham ,east_northeast,0.5179,23338,47158,46310,848,54200000,51990000,2210000
2022-10-01,Mukdahan ,east_northeast,0.5241,39314,154002,145071,8931,224500000,204250000,20250000
2022-10-01,Roi Et ,east_northeast,0.3704,24047,57113,56395,718,71320000,69570000,1750000
2022-10-01,Loei ,east_northeast,0.5576,93605,155388,154388,1000,310860000,307410000,3450000
2022-10-01,Sisaket ,south,0.3847,23359,67223,66872,351,77870000,77040000,830000
2022-10-01,Surin ,east_northeast,0.5085000000000001,65192,88645,86470,2175,154190000,149950000,4240000
2022-10-01,Nong Khai ,east_northeast,0.5167,65973,212285,162343,49942,348670000,232650000,116020000
2022-10-01,Bueng Kan ,east_northeast,0.5384,32195,61987,59823,2164,84730000,80340000,4390000
2022-10-01,Udon Thani ,east_northeast,0.5068,106566,293400,269957,23443,539760000,460580000,79180000
2022-10-01,Ubon Ratchathani ,east_northeast,0.3577,71278,160032,159218,814,219980000,218030000,1950000
2022-10-01,Sakon Nakhon ,east_northeast,0.5057,57142,142178,141175,1003,204120000,201520000,2600000
2022-10-01,Yasothon ,east_northeast,0.3428,9443,35400,35289,111,34560000,34410000,150000
2022-10-01,Amnat Charoen ,east_northeast,0.3344,5784,19311,19041,270,20720000,20280000,440000
2022-10-01,Nong Bua Lamphu ,east_northeast,0.34159999999999996,7615,26607,26456,151,20140000,19990000,150000
2022-11-01,Bangkok,central,0.6675,1942938,3963110,2336076,1627034,46335090000,12029990000,34305100000
2022-11-01,Lopburi ,central,0.4475,56397,324868,324051,817,394710000,393540000,1170000
2022-11-01,Phra Nakhon Si Ayutthaya ,central,0.6018,79253,804102,726915,77187,1238760000,1082680000,156080000
2022-11-01,Saraburi ,central,0.5869,84640,391329,389630,1699,620320000,617790000,2530000
2022-11-01,Chainat ,central,0.3811,13547,73476,73222,254,89150000,88930000,220000
2022-11-01,Nakhon Pathom ,central,0.5542,85433,304636,301890,2746,385380000,378560000,6820000
2022-11-01,Sing Buri ,central,0.3951,13921,57801,57269,532,74120000,73040000,1080000
2022-11-01,Ang Thong ,central,0.34759999999999996,7961,57792,57741,51,59680000,59610000,70000
2022-11-01,Nonthaburi ,central,0.5061,70146,266486,254853,11633,349430000,333440000,15990000
2022-11-01,Pathum Thani ,central,0.4147,34060,182253,175133,7120,250540000,241260000,9280000
2022-11-01,Samut Prakan ,central,0.46619999999999995,67914,308027,252007,56020,428050000,348910000,79140000
2022-11-01,Samut Sakhon ,central,0.35850000000000004,23405,62086,61695,391,82420000,81650000,770000
2022-11-01,Chachoengsao ,east,0.38189999999999996,26741,481958,481078,880,533860000,533020000,840000
2022-11-01,Ratchaburi ,central,0.5564,69905,146860,140442,6418,182100000,166150000,15950000
2022-11-01,Kanchanaburi ,central,0.6275,257582,1030323,1017874,12449,1961960000,1916130000,45830000
2022-11-01,Samut Songkhram ,central,0.5153,65755,468849,464590,4259,465880000,457960000,7920000
2022-11-01,Suphan Buri ,central,0.5085999999999999,66189,348132,344991,3141,455620000,450540000,5080000
2022-11-01,Phetchaburi ,central,0.6625,316488,828921,821386,7535,2385850000,2353520000,32330000
2022-11-01,Prachuap Khiri Khan ,central,0.7234,488942,978818,952768,26050,3302670000,3038990000,263680000
2022-11-01,Chonburi ,east,0.6928,1145160,1726398,1348886,377512,13061890000,8060000000,5001890000
2022-11-01,Chanthaburi ,east,0.4789,76234,117604,116560,1044,395830000,393510000,2320000
2022-11-01,Trat ,east,0.4018,98648,113113,104032,9081,749480000,689000000,60480000
2022-11-01,Nakhon Nayok ,east,0.6128,86089,140591,140320,271,316170000,315420000,750000
2022-11-01,Prachinburi ,east,0.3918,54579,87890,87614,276,232600000,231520000,1080000
2022-11-01,Rayong ,east,0.7635,224156,304398,288507,15891,1096460000,1048180000,48280000
2022-11-01,Sa Kaeo ,east,0.4899,37213,103279,102026,1253,322310000,319280000,3030000
2022-11-01,Phuket ,south,0.7937000000000001,617572,744203,265123,479080,25616140000,1810950000,23805190000
2022-11-01,Phatthalung ,south,0.5082,34367,62908,62375,533,66130000,65920000,210000
2022-11-01,Trang ,south,0.4838,62408,91572,89977,1595,311410000,306330000,5080000
2022-11-01,Ranong ,south,0.48200000000000004,33747,50998,50240,758,107020000,105030000,1990000
2022-11-01,Chumphon ,south,0.5131,81738,105477,104983,494,273790000,272590000,1200000
2022-11-01,Pattani ,south,0.39590000000000003,15363,25753,23347,2406,51760000,50680000,1080000
2022-11-01,Yala ,south,0.7437999999999999,82710,121119,87602,33517,232360000,147500000,84860000
2022-11-01,Nakhon Si Thammarat ,south,0.5395,134361,210802,209789,1013,535950000,533070000,2880000
2022-11-01,Narathiwat ,south,0.46590000000000004,25570,45270,28342,16928,96760000,49890000,46870000
2022-11-01,Krabi ,south,0.3728,96346,169617,133148,36469,1366050000,1157340000,208710000
2022-11-01,Songkhla ,south,0.5579,158927,302726,151250,151476,1733840000,820600000,913240000
2022-11-01,Phang Nga ,south,0.5332,53461,124864,76805,48059,558210000,216020000,342190000
2022-11-01,Surat Thani ,south,0.5594,267805,390854,283788,107066,2737770000,1595780000,1141990000
2022-11-01,Satun ,south,0.4387,62834,127439,122791,4648,436210000,418560000,17650000
2022-11-01,Kamphaeng Phet ,north,0.4067,31346,71989,69267,2722,127970000,122730000,5240000
2022-11-01,Chiang Rai ,north,0.7954000000000001,355701,534516,472511,62005,3876030000,3177390000,698640000
2022-11-01,Chiang Mai ,north,0.8219,634697,955184,701549,253635,7027240000,4791780000,2235460000
2022-11-01,Phichit ,north,0.5543,31738,62868,62782,86,103080000,102880000,200000
2022-11-01,Nakhon Sawan ,north,0.5286,82118,174974,174434,540,438350000,436500000,1850000
2022-11-01,Tak ,north,0.7354,138675,193252,190912,2340,593930000,583360000,10570000
2022-11-01,Phitsanulok ,north,0.5146999999999999,132398,244500,237668,6832,625640000,606160000,19480000
2022-11-01,Phayao ,north,0.6822,40453,92261,88447,3814,186650000,176020000,10630000
2022-11-01,Phetchabun ,north,0.6053000000000001,169807,219610,214397,5213,709360000,690940000,18420000
2022-11-01,Phrae ,north,0.6541,46151,117116,116232,884,247600000,245310000,2290000
2022-11-01,Lampang ,north,0.7245999999999999,56389,160831,157086,3745,458610000,441580000,17030000
2022-11-01,Lamphun ,north,0.6912,22281,111426,107267,4159,141860000,133250000,8610000
2022-11-01,Mae Hong Son ,north,0.5886,89215,103030,89936,13094,441910000,368820000,73090000
2022-11-01,Uttaradit ,north,0.4672,45502,91728,91141,587,129910000,128450000,1460000
2022-11-01,Uthai Thani ,north,0.4376,25298,86925,86904,21,126120000,126080000,40000
2022-11-01,Sukhothai ,north,0.4661,48411,118619,104661,13958,275000000,233730000,41270000
2022-11-01,Nan ,north,0.7537999999999999,85948,129205,127803,1402,306880000,299270000,7610000
2022-11-01,Kalasin ,east_northeast,0.4608,19946,55340,54415,925,59110000,56160000,2950000
2022-11-01,Khon Kaen ,east_northeast,0.6142,166964,358515,350514,8001,999930000,980270000,19660000
2022-11-01,Chaiyaphum ,east_northeast,0.35869999999999996,46668,82421,82032,389,106620000,105740000,880000
2022-11-01,Nakhon Phanom ,east_northeast,0.6886,57023,147795,139551,8244,220600000,200970000,19630000
2022-11-01,Nakhon Ratchasima ,east_northeast,0.5624,314951,528436,517166,11270,917470000,881740000,35730000
2022-11-01,Buriram ,east_northeast,0.6096,117539,261557,258723,2834,501460000,493870000,7590000
2022-11-01,Maha Sarakham ,east_northeast,0.5418999999999999,24207,48833,47934,899,56230000,53850000,2380000
2022-11-01,Mukdahan ,east_northeast,0.5134000000000001,38734,152020,143050,8970,222590000,202130000,20460000
2022-11-01,Roi Et ,east_northeast,0.3849,24352,57853,57089,764,73030000,71130000,1900000
2022-11-01,Loei ,east_northeast,0.5831000000000001,97739,162782,160696,2086,336700000,329380000,7320000
2022-11-01,Sisaket ,south,0.3967,23861,68570,68190,380,80910000,80010000,900000
2022-11-01,Surin ,east_northeast,0.6082,76423,103529,101112,2417,187860000,183050000,4810000
2022-11-01,Nong Khai ,east_northeast,0.5045000000000001,64414,207782,156748,51034,339500000,220990000,118510000
2022-11-01,Bueng Kan ,east_northeast,0.5224,31232,59352,56980,2372,79890000,75060000,4830000
2022-11-01,Udon Thani ,east_northeast,0.4928,103471,285304,260951,24353,518960000,436350000,82610000
2022-11-01,Ubon Ratchathani ,east_northeast,0.42369999999999997,78351,175982,175101,881,246780000,244650000,2130000
2022-11-01,Sakon Nakhon ,east_northeast,0.47869999999999996,55106,137601,136731,870,196110000,193860000,2250000
2022-11-01,Yasothon ,east_northeast,0.35810000000000003,9642,36051,35897,154,35630000,35420000,210000
2022-11-01,Amnat Charoen ,east_northeast,0.3452,6045,20325,20032,293,22000000,21510000,490000
2022-11-01,Nong Bua Lamphu ,east_northeast,0.3329,7530,26351,26186,165,19830000,19670000,160000
2022-12-01,Bangkok,central,0.7004,2222569,4583029,2658833,1924196,54568980000,13567280000,41001700000
2022-12-01,Lopburi ,central,0.4991,61977,338074,336907,1167,417360000,415650000,1710000
2022-12-01,Phra Nakhon Si Ayutthaya ,central,0.6213000000000001,83905,852000,755148,96852,1329650000,1132910000,196740000
2022-12-01,Saraburi ,central,0.642,93710,421539,418863,2676,676250000,672210000,4040000
2022-12-01,Chainat ,central,0.41850000000000004,15509,79343,79056,287,101010000,100760000,250000
2022-12-01,Nakhon Pathom ,central,0.5046,78307,290190,287317,2873,373880000,366690000,7190000
2022-12-01,Sing Buri ,central,0.3859,13024,62707,61888,819,75210000,73540000,1670000
2022-12-01,Ang Thong ,central,0.40340000000000004,9590,64716,64388,328,69840000,69450000,390000
2022-12-01,Nonthaburi ,central,0.5232,73876,281264,268744,12520,362030000,344630000,17400000
2022-12-01,Pathum Thani ,central,0.46090000000000003,38085,237606,227298,10308,336330000,322590000,13740000
2022-12-01,Samut Prakan ,central,0.496,73415,298289,238982,59307,423760000,338370000,85390000
2022-12-01,Samut Sakhon ,central,0.4017,28424,75895,75449,446,102860000,101960000,900000
2022-12-01,Chachoengsao ,east,0.4255,30212,464967,463922,1045,521400000,520390000,1010000
2022-12-01,Ratchaburi ,central,0.5821999999999999,83382,194719,187980,6739,235930000,218290000,17640000
2022-12-01,Kanchanaburi ,central,0.6397999999999999,293434,1163685,1150796,12889,2236360000,2187820000,48540000
2022-12-01,Samut Songkhram ,central,0.5704,70438,514438,510015,4423,510600000,502330000,8270000
2022-12-01,Suphan Buri ,central,0.6520999999999999,99002,538129,534729,3400,699270000,693600000,5670000
2022-12-01,Phetchaburi ,central,0.6820999999999999,324834,877418,868724,8694,2513280000,2474730000,38550000
2022-12-01,Prachuap Khiri Khan ,central,0.7922,533496,1068543,1032589,35954,3698080000,3334110000,363970000
2022-12-01,Chonburi ,east,0.8359000000000001,1384373,2159207,1654689,504518,16552410000,9566800000,6985610000
2022-12-01,Chanthaburi ,east,0.5097999999999999,78619,120461,119124,1337,413990000,411020000,2970000
2022-12-01,Trat ,east,0.48719999999999997,129248,148645,137474,11171,1006320000,929260000,77060000
2022-12-01,Nakhon Nayok ,east,0.6888,92973,174768,174450,318,413290000,412370000,920000
2022-12-01,Prachinburi ,east,0.48340000000000005,61315,104814,104298,516,283550000,281830000,1720000
2022-12-01,Rayong ,east,0.7851,260807,470702,441226,29476,1677360000,1588810000,88550000
2022-12-01,Sa Kaeo ,east,0.5476,40958,111106,109663,1443,353460000,349990000,3470000
2022-12-01,Phuket ,south,0.8253,656246,797812,286569,511243,26865930000,1923940000,24941990000
2022-12-01,Phatthalung ,south,0.6029,39914,79132,78327,805,80880000,80570000,310000
2022-12-01,Trang ,south,0.5249,66532,98806,96643,2163,330430000,323680000,6750000
2022-12-01,Ranong ,south,0.5147999999999999,35879,55041,54025,1016,113380000,110750000,2630000
2022-12-01,Chumphon ,south,0.5539000000000001,87595,111443,110814,629,284070000,282570000,1500000
2022-12-01,Pattani ,south,0.4146,15971,27577,25007,2570,54400000,53270000,1130000
2022-12-01,Yala ,south,0.7651,87181,130095,91036,39059,247370000,149930000,97440000
2022-12-01,Nakhon Si Thammarat ,south,0.6146,151117,242870,241620,1250,593870000,590380000,3490000
2022-12-01,Narathiwat ,south,0.4794,26538,49742,30943,18799,104850000,53560000,51290000
2022-12-01,Krabi ,south,0.5228,114231,204840,149100,55740,1584870000,1269800000,315070000
2022-12-01,Songkhla ,south,0.6357,176091,342503,166390,176113,1930910000,887960000,1042950000
2022-12-01,Phang Nga ,south,0.6045,58982,136889,80374,56515,622900000,221530000,401370000
2022-12-01,Surat Thani ,south,0.6162,291680,434562,305037,129525,3022780000,1669540000,1353240000
2022-12-01,Satun ,south,0.5337,70763,140609,132531,8078,472790000,442560000,30230000
2022-12-01,Kamphaeng Phet ,north,0.4157,32085,80275,77202,3073,144790000,138760000,6030000
2022-12-01,Chiang Rai ,north,0.9074,407728,648253,580058,68195,4739830000,3956160000,783670000
2022-12-01,Chiang Mai ,north,0.9551000000000001,732873,1146951,800366,346585,8746650000,5566280000,3180370000
2022-12-01,Phichit ,north,0.6225999999999999,34592,68312,68194,118,114710000,114430000,280000
2022-12-01,Nakhon Sawan ,north,0.5465,85306,194043,193401,642,493300000,491050000,2250000
2022-12-01,Tak ,north,0.7623000000000001,147351,213820,210429,3391,676980000,661380000,15600000
2022-12-01,Phitsanulok ,north,0.5834,146662,278428,270270,8158,727810000,703940000,23870000
2022-12-01,Phayao ,north,0.7693000000000001,45091,106813,102449,4364,219890000,207490000,12400000
2022-12-01,Phetchabun ,north,0.7049,192294,252653,246079,6574,835250000,811500000,23750000
2022-12-01,Phrae ,north,0.7286,51177,129692,128703,989,277910000,275280000,2630000
2022-12-01,Lampang ,north,0.8209000000000001,63493,183020,177466,5554,534240000,508340000,25900000
2022-12-01,Lamphun ,north,0.7564,24482,127973,121662,6311,168730000,155170000,13560000
2022-12-01,Mae Hong Son ,north,0.6524,98459,114661,98450,16211,509470000,416920000,92550000
2022-12-01,Uttaradit ,north,0.5067,49106,104542,103908,634,151830000,150200000,1630000
2022-12-01,Uthai Thani ,north,0.5302,28206,95097,95068,29,143780000,143720000,60000
2022-12-01,Sukhothai ,north,0.4518,48123,114671,100907,13764,269860000,228960000,40900000
2022-12-01,Nan ,north,0.8756,99249,144646,143095,1551,353060000,344430000,8630000
2022-12-01,Kalasin ,east_northeast,0.4756,20570,57136,56075,1061,62010000,58590000,3420000
2022-12-01,Khon Kaen ,east_northeast,0.6289,169886,366546,358466,8080,1025040000,1005100000,19940000
2022-12-01,Chaiyaphum ,east_northeast,0.5035000000000001,59010,104006,103551,455,139490000,138420000,1070000
2022-12-01,Nakhon Phanom ,east_northeast,0.7242000000000001,60190,155891,147209,8682,240260000,219490000,20770000
2022-12-01,Nakhon Ratchasima ,east_northeast,0.8001999999999999,450192,759205,747434,11771,1330200000,1292340000,37860000
2022-12-01,Buriram ,east_northeast,0.6849,129964,294927,292009,2918,591130000,582960000,8170000
2022-12-01,Maha Sarakham ,east_northeast,0.5816,25636,51644,50714,930,60460000,57980000,2480000
2022-12-01,Mukdahan ,east_northeast,0.5277000000000001,40182,156862,147843,9019,232310000,211420000,20890000
2022-12-01,Roi Et ,east_northeast,0.4047,25426,60511,59722,789,77020000,75090000,1930000
2022-12-01,Loei ,east_northeast,0.6199,102632,171539,169357,2182,367210000,359430000,7780000
2022-12-01,Sisaket ,south,0.45399999999999996,26164,74755,74360,395,89480000,88530000,950000
2022-12-01,Surin ,east_northeast,0.6264,78705,106497,104148,2349,189430000,184810000,4620000
2022-12-01,Nong Khai ,east_northeast,0.6592,83594,227206,175542,51664,400100000,279320000,120780000
2022-12-01,Bueng Kan ,east_northeast,0.5372,31740,61277,58885,2392,85980000,81060000,4920000
2022-12-01,Udon Thani ,east_northeast,0.6062,125559,334558,310100,24458,636280000,553340000,82940000
2022-12-01,Ubon Ratchathani ,east_northeast,0.5078,90629,198206,197183,1023,283940000,281460000,2480000
2022-12-01,Sakon Nakhon ,east_northeast,0.539,59388,147162,145810,1352,213790000,210270000,3520000
2022-12-01,Yasothon ,east_northeast,0.3686,10022,37251,37105,146,36810000,36600000,210000
2022-12-01,Amnat Charoen ,east_northeast,0.3763,6603,22573,22176,397,24660000,24000000,660000
2022-12-01,Nong Bua Lamphu ,east_northeast,0.3458,7947,27585,27391,194,20970000,20770000,200000
2023-01-01,Bangkok,central,0.7502,2440463,4872078,2749877,2122201,55773570000,14233350000,41540220000
2023-01-01,Kanchanaburi ,central,0.6729,320803,1312830,1297024,15806,2488940000,2438790000,50150000
2023-01-01,Nakhon Pathom ,central,0.4832,73725,282857,278774,4083,367540000,357160000,10380000
2023-01-01,Prachuap Khiri Khan ,central,0.7978000000000001,536710,1124160,1085120,39040,3984500000,3599450000,385050000
2023-01-01,Phetchaburi ,central,0.6954,343526,962457,950890,11567,2596850000,2551100000,45750000
2023-01-01,Ratchaburi ,central,0.6505,98414,213366,204019,9347,257220000,237370000,19850000
2023-01-01,Samut Prakan ,central,0.5103,80571,293913,226835,67078,421360000,316650000,104710000
2023-01-01,Samut Songkhram ,central,0.5992999999999999,75514,567982,558144,9838,560760000,547140000,13620000
2023-01-01,Samut Sakhon ,central,0.4425,30143,91058,90243,815,126060000,124390000,1670000
2023-01-01,Chainat ,central,0.4277,15723,73856,73337,519,95780000,95310000,470000
2023-01-01,Nonthaburi ,central,0.5517,80761,318037,301677,16360,417800000,394990000,22810000
2023-01-01,Pathum Thani ,central,0.4347,34221,221753,204648,17105,308740000,285630000,23110000
2023-01-01,Phra Nakhon Si Ayutthaya ,central,0.6282,87431,887134,769546,117588,1423030000,1179840000,243190000
2023-01-01,Lopburi ,central,0.5827,77379,387985,386177,1808,488250000,485560000,2690000
2023-01-01,Saraburi ,central,0.6006,84820,403863,400496,3367,652210000,647010000,5200000
2023-01-01,Sing Buri ,central,0.4028,14027,57110,56482,628,70020000,68710000,1310000
2023-01-01,Suphan Buri ,central,0.6577,105273,604130,599655,4475,750870000,744160000,6710000
2023-01-01,Ang Thong ,central,0.4476,10762,75492,74944,548,82710000,81980000,730000
2023-01-01,Chanthaburi ,east,0.5921,91719,180927,178692,2235,624150000,619170000,4980000
2023-01-01,Chachoengsao ,east,0.4164,30736,456049,454756,1293,514630000,513330000,1300000
2023-01-01,Chonburi ,east,0.7857999999999999,1347044,2089034,1452362,636672,16432470000,8788730000,7643740000
2023-01-01,Trat ,east,0.5573,140368,159330,143918,15412,1065310000,955060000,110250000
2023-01-01,Nakhon Nayok ,east,0.6353,86714,133252,132274,978,311680000,308550000,3130000
2023-01-01,Prachinburi ,east,0.4679,58964,100643,100068,575,280980000,278990000,1990000
2023-01-01,Rayong ,east,0.6939,233839,399136,370439,28697,1440380000,1355130000,85250000
2023-01-01,Sa Kaeo ,east,0.48479999999999995,38260,105339,103953,1386,341970000,338610000,3360000
2023-01-01,Krabi ,south,0.6642,134344,245504,161205,84299,2030190000,1559770000,470420000
2023-01-01,Chumphon ,south,0.5861,92948,116722,115980,742,292230000,290500000,1730000
2023-01-01,Nakhon Si Thammarat ,south,0.6346,158855,263044,261513,1531,631390000,627190000,4200000
2023-01-01,Phang Nga ,south,0.6835,65600,151750,84747,67003,767700000,300910000,466790000
2023-01-01,Phuket ,south,0.8270000000000001,681547,833476,250409,583067,27760220000,1629960000,26130260000
2023-01-01,Ranong ,south,0.5425,37865,58686,57440,1246,118590000,115420000,3170000
2023-01-01,Surat Thani ,south,0.726,332258,489597,331730,157867,3372830000,1766469999,1606360000
2023-01-01,Trang ,south,0.5487,70089,104725,101773,2952,349229999,340140000,9090000
2023-01-01,Narathiwat ,south,0.5159,28320,56203,34195,22008,117240000,58200000,59040000
2023-01-01,Pattani ,south,0.3933,15118,25828,23343,2485,49900000,48830000,1070000
2023-01-01,Phatthalung ,south,0.6195,41586,88587,87684,903,89090000,88390000,700000
2023-01-01,Yala ,south,0.7314,81641,119386,83128,36258,236150000,134470000,101680000
2023-01-01,Songkhla ,south,0.6584,185930,367688,176248,191440,2110000000,969530000,1140470000
2023-01-01,Satun ,south,0.5849,76309,150346,139460,10886,539860000,499800000,40060000
2023-01-01,Chiang Rai ,north,0.8916,405508,650168,572855,77313,4807170000,3896000000,911170000
2023-01-01,Chiang Mai ,north,0.9289000000000001,724446,1154857,869177,285680,8803430000,6096060000,2707370000
2023-01-01,Nan ,north,0.9083,104721,147316,145671,1645,362020000,352580000,9440000
2023-01-01,Phayao ,north,0.7437999999999999,44578,101250,95687,5563,214440000,197840000,16600000
2023-01-01,Phrae ,north,0.6972,50638,123606,122649,957,269760000,267180000,2580000
2023-01-01,Mae Hong Son ,north,0.6384000000000001,98309,115027,98527,16500,513190000,417660000,95530000
2023-01-01,Lampang ,north,0.7286,60876,174542,167863,6679,524670000,492180000,32490000
2023-01-01,Lamphun ,north,0.7502,24351,125383,117980,7403,168540000,152140000,16399999
2023-01-01,Kamphaeng Phet ,north,0.3922,31772,75521,72784,2737,141150000,135540000,5610000
2023-01-01,Tak ,north,0.7541,146624,206259,201611,4648,667060000,645050000,22010000
2023-01-01,Nakhon Sawan ,north,0.5583,86879,195562,194758,804,500240000,497370000,2870000
2023-01-01,Phichit ,north,0.5478000000000001,33020,64987,64835,152,111990000,111620000,370000
2023-01-01,Phitsanulok ,north,0.5724,146196,286106,276634,9472,757750000,729530000,28220000
2023-01-01,Phetchabun ,north,0.6517000000000001,188195,250782,243117,7665,835160000,806260000,28900000
2023-01-01,Sukhothai ,north,0.3987,47124,110895,95912,14983,268930000,222960000,45970000
2023-01-01,Uttaradit ,north,0.42710000000000004,46951,95628,95005,623,143740000,142120000,1620000
2023-01-01,Uthai Thani ,north,0.5165,28011,89179,89072,107,138790000,138590000,200000
2023-01-01,Kalasin ,east_northeast,0.4631,19979,55621,54710,911,60000000,57120000,2880000
2023-01-01,Khon Kaen ,east_northeast,0.6082,164270,333766,324117,9649,945210000,918550000,26660000
2023-01-01,Nakhon Phanom ,east_northeast,0.736,62425,164365,155168,9197,256180000,233880000,22300000
2023-01-01,Bueng Kan ,east_northeast,0.5478000000000001,32938,61593,59397,2196,87080000,82650000,4430000
2023-01-01,Maha Sarakham ,east_northeast,0.6013000000000001,27775,55563,54748,815,65910000,63820000,2090000
2023-01-01,Loei ,east_northeast,0.6317,103572,173075,170820,2255,375450000,367310000,8140000
2023-01-01,Sakon Nakhon ,east_northeast,0.5224,56778,143484,142187,1297,206460000,203090000,3370000
2023-01-01,Nong Khai ,east_northeast,0.6441,81251,229295,166814,62481,405370000,261810000,143560000
2023-01-01,Nong Bua Lamphu ,east_northeast,0.36729999999999996,8286,28757,28515,242,22070000,21830000,240000
2023-01-01,Udon Thani ,east_northeast,0.6851,142271,381671,332135,49536,794579999,624630000,169950000
2023-01-01,Chaiyaphum ,east_northeast,0.4777,56333,100242,99800,442,141890000,140890000,1000000
2023-01-01,Nakhon Ratchasima ,east_northeast,0.6907,396520,677058,666341,10717,1154110000,1120090000,34020000
2023-01-01,Buriram ,east_northeast,0.735,144765,305026,301517,3509,627829999,617300000,10530000
2023-01-01,Mukdahan ,east_northeast,0.5408,42104,162926,153645,9281,244640000,222420000,22220000
2023-01-01,Yasothon ,east_northeast,0.3957,10527,37655,37496,159,37400000,37170000,230000
2023-01-01,Roi Et ,east_northeast,0.6356,45619,106144,105296,848,139700000,137510000,2190000
2023-01-01,Sisaket ,south,0.4294,24872,68769,68441,328,80290000,79530000,760000
2023-01-01,Surin ,east_northeast,0.5808,75991,104405,102229,2176,185200000,180950000,4250000
2023-01-01,Amnat Charoen ,east_northeast,0.3946,6934,23112,22684,428,25960000,25170000,790000
2023-01-01,Ubon Ratchathani ,east_northeast,0.48109999999999997,87474,201036,199911,1125,296130000,293390000,2740000
2023-02-01,Bangkok,central,0.7597,2427838,4697654,2540268,2157386,56007210000,13321820000,42685390000
2023-02-01,Kanchanaburi ,central,0.6523,298484,1229084,1206651,22433,2315770000,2248150000,67620000
2023-02-01,Nakhon Pathom ,central,0.4387,68431,253919,250065,3854,339900000,329990000,9910000
2023-02-01,Prachuap Khiri Khan ,central,0.7526,484460,953266,906822,46444,3420450000,2955740000,464710000
2023-02-01,Phetchaburi ,central,0.6709,319600,861806,848877,12929,2355980000,2304310000,51670000
2023-02-01,Ratchaburi ,central,0.5635,68884,177957,166502,11455,203600000,179770000,23830000
2023-02-01,Samut Prakan ,central,0.48229999999999995,73380,258047,189960,68087,376080000,269020000,107060000
2023-02-01,Samut Songkhram ,central,0.5882000000000001,59707,536843,522861,13982,507160000,489450000,17710000
2023-02-01,Samut Sakhon ,central,0.41119999999999995,26505,85102,83562,1540,119340000,116200000,3140000
2023-02-01,Chainat ,central,0.45030000000000003,17049,76937,76531,406,101030000,100650000,380000
2023-02-01,Nonthaburi ,central,0.5371,74541,293563,275729,17834,396580000,371370000,25210000
2023-02-01,Pathum Thani ,central,0.4545,33672,203466,184300,19166,292710000,266360000,26350000
2023-02-01,Phra Nakhon Si Ayutthaya ,central,0.5878,80566,828263,718340,109923,1353750000,1120820000,232930000
2023-02-01,Lopburi ,central,0.5383,66173,347038,344986,2052,428850000,425750000,3100000
2023-02-01,Saraburi ,central,0.5468999999999999,76562,356692,353568,3124,589520000,584660000,4860000
2023-02-01,Sing Buri ,central,0.42119999999999996,13242,51144,50618,526,64240000,63130000,1110000
2023-02-01,Suphan Buri ,central,0.6285000000000001,88229,552498,547028,5470,646410000,638510000,7900000
2023-02-01,Ang Thong ,central,0.4844,13167,87375,86891,484,97380000,96720000,660000
2023-02-01,Chanthaburi ,east,0.6467,96711,329667,326710,2957,1140350000,1134250000,6100000
2023-02-01,Chachoengsao ,east,0.3987,28121,431321,430154,1167,478120000,476970000,1150000
2023-02-01,Chonburi ,east,0.7474,1195173,1765942,1053257,712685,13916540000,5526110000,8390430000
2023-02-01,Trat ,east,0.5442,124282,142183,127685,14498,945360000,840980000,104380000
2023-02-01,Nakhon Nayok ,east,0.5997,84037,131283,130339,944,306000000,302980000,3020000
2023-02-01,Prachinburi ,east,0.4474,55057,99191,98755,436,277280000,275750000,1530000
2023-02-01,Rayong ,east,0.6612,228041,392286,358862,33424,1410470000,1310320000,100150000
2023-02-01,Sa Kaeo ,east,0.4608,36084,99892,98569,1323,324380000,321170000,3210000
2023-02-01,Krabi ,south,0.7552,152480,288357,168938,119419,2255870000,1601270000,654600000
2023-02-01,Chumphon ,south,0.6089,97457,125871,125056,815,308060000,306200000,1860000
2023-02-01,Nakhon Si Thammarat ,south,0.6531999999999999,166307,276244,274453,1791,647180000,642370000,4810000
2023-02-01,Phang Nga ,south,0.6523,61794,230469,74426,156043,980200000,256920000,723280000
2023-02-01,Phuket ,south,0.8519,773321,950848,262850,687998,29607030000,1672670000,27934360000
2023-02-01,Ranong ,south,0.5737,40081,62771,61369,1402,124430000,120930000,3500000
2023-02-01,Surat Thani ,south,0.7484000000000001,349766,527449,345093,182356,3597540000,1797490000,1800050000
2023-02-01,Trang ,south,0.5635,73095,109183,105800,3383,355580000,345370000,10210000
2023-02-01,Narathiwat ,south,0.5562,30238,65895,38315,27580,136880000,64170000,72710000
2023-02-01,Pattani ,south,0.442,16263,28033,25424,2609,53070000,51970000,1100000
2023-02-01,Phatthalung ,south,0.6014,39524,90971,89997,974,89420000,88680000,740000
2023-02-01,Yala ,south,0.7957,89915,134064,87612,46452,266960000,138750000,128210000
2023-02-01,Songkhla ,south,0.6353,176046,358211,160445,197766,2023920000,852570000,1171350000
2023-02-01,Satun ,south,0.563,72416,144382,134740,9642,588400000,553970000,34430000
2023-02-01,Chiang Rai ,north,0.7548,332976,560745,486143,74602,4147900000,3251590000,896310000
2023-02-01,Chiang Mai ,north,0.7593000000000001,605913,942945,698328,244617,7377560000,5037850000,2339710000
2023-02-01,Nan ,north,0.9351,118965,180728,179116,1612,455740000,446390000,9350000
2023-02-01,Phayao ,north,0.7563,45035,96128,91398,4730,207320000,192730000,14590000
2023-02-01,Phrae ,north,0.6586,47221,113825,112853,972,255840000,253200000,2640000
2023-02-01,Mae Hong Son ,north,0.586,91251,105495,87088,18407,488060000,378960000,109100000
2023-02-01,Lampang ,north,0.6028,52194,142332,136269,6063,446170000,415160000,31010000
2023-02-01,Lamphun ,north,0.604,20293,97673,91024,6649,137670000,122300000,15370000
2023-02-01,Kamphaeng Phet ,north,0.40240000000000004,32941,71639,69156,2483,136549999,131260000,5290000
2023-02-01,Tak ,north,0.7218000000000001,137389,190910,185911,4999,637650000,613620000,24030000
2023-02-01,Nakhon Sawan ,north,0.5206000000000001,82503,182453,181698,755,481030000,478300000,2730000
2023-02-01,Phichit ,north,0.5162,31708,59261,59126,135,106830000,106490000,340000
2023-02-01,Phitsanulok ,north,0.509,131376,260109,249685,10424,702610000,670330000,32280000
2023-02-01,Phetchabun ,north,0.6746,191571,262679,255218,7461,889050000,860120000,28930000
2023-02-01,Sukhothai ,north,0.3893,46381,98421,80663,17758,249340000,193440000,55900000
2023-02-01,Uttaradit ,north,0.42060000000000003,46461,88505,87942,563,138670000,137170000,1500000
2023-02-01,Uthai Thani ,north,0.5082,27584,80105,80010,95,127980000,127790000,190000
2023-02-01,Kalasin ,east_northeast,0.5784,25610,76200,73805,2395,86990000,79330000,7660000
2023-02-01,Khon Kaen ,east_northeast,0.5802,159207,323385,314381,9004,880230000,856220000,24010000
2023-02-01,Nakhon Phanom ,east_northeast,0.76,65810,177898,167277,10621,284480000,257440000,27040000
2023-02-01,Bueng Kan ,east_northeast,0.5052,31029,57632,55710,1922,77960000,74320000,3640000
2023-02-01,Maha Sarakham ,east_northeast,0.5361,25011,51326,50572,754,60210000,58350000,1860000
2023-02-01,Loei ,east_northeast,0.6077,100440,165602,163379,2223,356640000,348700000,7940000
2023-02-01,Sakon Nakhon ,east_northeast,0.5031,55532,149330,148126,1204,201730000,198660000,3070000
2023-02-01,Nong Khai ,east_northeast,0.6548999999999999,83983,250754,186094,64660,424120000,275970000,148150000
2023-02-01,Nong Bua Lamphu ,east_northeast,0.33299999999999996,7684,26659,26495,164,19970000,19820000,150000
2023-02-01,Udon Thani ,east_northeast,0.6239,129989,329825,287940,41885,661880000,520440000,141440000
2023-02-01,Chaiyaphum ,east_northeast,0.4461,53330,94804,94390,414,128520000,127600000,920000
2023-02-01,Nakhon Ratchasima ,east_northeast,0.6415000000000001,359110,612608,602824,9784,1037380000,1007500000,29880000
2023-02-01,Buriram ,east_northeast,0.6817,131056,273722,270392,3330,550940000,541250000,9690000
2023-02-01,Mukdahan ,east_northeast,0.5112,40096,158380,149425,8955,234090000,213440000,20650000
2023-02-01,Yasothon ,east_northeast,0.3839,10171,36381,36262,119,35850000,35680000,170000
2023-02-01,Roi Et ,east_northeast,0.5297,32125,67845,67115,730,90520000,88600000,1920000
2023-02-01,Sisaket ,south,0.3982,21548,56593,56284,309,65190000,64489999,700000
2023-02-01,Surin ,east_northeast,0.551,71567,98256,96184,2072,170750000,166750000,4000000
2023-02-01,Amnat Charoen ,east_northeast,0.3809,6589,21896,21496,400,23700000,22980000,720000
2023-02-01,Ubon Ratchathani ,east_northeast,0.45399999999999996,83749,408846,407653,1193,616180000,613220000,2960000
2023-03-01,Bangkok,central,0.7796,2527890,4669908,2498933,2170975,56033170000,12753290000,43279880000
2023-03-01,Kanchanaburi ,central,0.6129,283751,1170150,1147036,23114,2180000000,2110020000,69980000
2023-03-01,Nakhon Pathom ,central,0.46630000000000005,72027,261425,257174,4251,350720000,339940000,10780000
2023-03-01,Prachuap Khiri Khan ,central,0.7659999999999999,503046,952565,908434,44131,3445440000,3001560000,443880000
2023-03-01,Phetchaburi ,central,0.7021,340148,894909,883167,11742,2439900000,2393390000,46510000
2023-03-01,Ratchaburi ,central,0.5186,64226,170631,158150,12481,192770000,168090000,24680000
2023-03-01,Samut Prakan ,central,0.5212,79278,279984,208051,71933,398160000,285870000,112290000
2023-03-01,Samut Songkhram ,central,0.5569,55804,529882,515161,14721,491860000,472620000,19240000
2023-03-01,Samut Sakhon ,central,0.38780000000000003,25961,85392,83873,1519,116540000,113430000,3110000
2023-03-01,Chainat ,central,0.4355,16737,72338,71732,606,96910000,96370000,540000
2023-03-01,Nonthaburi ,central,0.5676,79284,285391,266929,18462,377720000,351280000,26440000
2023-03-01,Pathum Thani ,central,0.4794,34946,220870,199107,21763,310450000,281290000,29160000
2023-03-01,Phra Nakhon Si Ayutthaya ,central,0.5517,76982,772015,653554,118461,1247360000,998840000,248520000
2023-03-01,Lopburi ,central,0.4918,59025,311799,309863,1936,384920000,381990000,2930000
2023-03-01,Saraburi ,central,0.5636,80149,318397,314957,3440,538699999,533310000,5390000
2023-03-01,Sing Buri ,central,0.41619999999999996,13677,51908,51583,325,64850000,64180000,670000
2023-03-01,Suphan Buri ,central,0.5753,76257,530507,526807,3700,599670000,594420000,5250000
2023-03-01,Ang Thong ,central,0.4472,12665,71186,70573,613,85190000,84350000,840000
2023-03-01,Chanthaburi ,east,0.6927,114671,764033,760662,3371,2445550000,2438510000,7040000
2023-03-01,Chachoengsao ,east,0.4029,29399,467889,466836,1053,525510000,524460000,1050000
2023-03-01,Chonburi ,east,0.7643000000000001,1247582,1886845,1073295,813550,16885760000,5704730000,11181030000
2023-03-01,Trat ,east,0.5997,142038,170934,153362,17572,1133500000,1006750000,126750000
2023-03-01,Nakhon Nayok ,east,0.6103000000000001,88256,135914,134933,981,315800000,312700000,3100000
2023-03-01,Prachinburi ,east,0.47609999999999997,58324,102230,101857,373,283230000,281850000,1380000
2023-03-01,Rayong ,east,0.7295999999999999,253291,429511,368257,61254,1530220000,1345890000,184330000
2023-03-01,Sa Kaeo ,east,0.4756,36848,103275,101721,1554,335010000,331280000,3730000
2023-03-01,Krabi ,south,0.7748999999999999,171774,344089,182058,162031,2499529999,1653220000,846310000
2023-03-01,Chumphon ,south,0.5877,92671,122880,121998,882,296340000,294310000,2030000
2023-03-01,Nakhon Si Thammarat ,south,0.68,170682,289250,286617,2633,672020000,664960000,7060000
2023-03-01,Phang Nga ,south,0.701,81300,277492,87992,189500,1226260000,302000000,924260000
2023-03-01,Phuket ,south,0.8737999999999999,815441,997205,248051,749154,30740830000,1554600000,29186230000
2023-03-01,Ranong ,south,0.5453,38265,61307,59820,1487,120900000,117130000,3770000
2023-03-01,Surat Thani ,south,0.7881999999999999,420361,617912,395059,222853,4048450000,1949180000,2099270000
2023-03-01,Trang ,south,0.5428000000000001,67062,109024,105304,3720,338740000,327470000,11270000
2023-03-01,Narathiwat ,south,0.5274,28653,65257,35620,29637,136840000,58700000,78140000
2023-03-01,Pattani ,south,0.4277,13236,24209,21412,2797,45510000,44320000,1190000
2023-03-01,Phatthalung ,south,0.5767,37657,103136,101910,1226,99780000,98800000,980000
2023-03-01,Yala ,south,0.6983,77982,118910,76258,42652,247390000,129450000,117940000
2023-03-01,Songkhla ,south,0.6495000000000001,194372,373786,162901,210885,2093950000,863790000,1230160000
2023-03-01,Satun ,south,0.5908,80658,160082,146729,13353,650110000,604240000,45870000
2023-03-01,Chiang Rai ,north,0.6965,332046,530952,463321,67631,3816930000,2989420000,827510000
2023-03-01,Chiang Mai ,north,0.6246,500654,799314,585467,213847,5944620000,3895260000,2049360000
2023-03-01,Nan ,north,0.7283,96414,137639,136358,1281,360390000,352750000,7640000
2023-03-01,Phayao ,north,0.6034,39463,84443,80265,4178,185580000,172490000,13090000
2023-03-01,Phrae ,north,0.5922,45673,99007,98115,892,232170000,229710000,2460000
2023-03-01,Mae Hong Son ,north,0.4976,84032,96055,76301,19754,458680000,339550000,119130000
2023-03-01,Lampang ,north,0.43450000000000005,43518,116994,111682,5312,364800000,336690000,28110000
2023-03-01,Lamphun ,north,0.4568,17563,85504,79344,6160,120310000,105830000,14480000
2023-03-01,Kamphaeng Phet ,north,0.365,32164,64972,62696,2276,123970000,119040000,4930000
2023-03-01,Tak ,north,0.6265999999999999,126810,174690,169910,4780,576380000,553050000,23330000
2023-03-01,Nakhon Sawan ,north,0.5961,89991,195465,194591,874,515660000,512230000,3430000
2023-03-01,Phichit ,north,0.4329,27756,53300,53186,114,94620000,94320000,300000
2023-03-01,Phitsanulok ,north,0.41609999999999997,112437,214086,204123,9963,580850000,549520000,31330000
2023-03-01,Phetchabun ,north,0.5089,165710,218749,212705,6044,744020000,719750000,24270000
2023-03-01,Sukhothai ,north,0.3517,45543,94041,77883,16158,233790000,181780000,52010000
2023-03-01,Uttaradit ,north,0.4073,46093,81823,81287,536,129850000,128400000,1450000
2023-03-01,Uthai Thani ,north,0.48960000000000004,27412,76748,76673,75,125110000,124950000,160000
2023-03-01,Kalasin ,east_northeast,0.6079,26986,162078,159669,2409,181030000,173320000,7710000
2023-03-01,Khon Kaen ,east_northeast,0.5407,144316,298691,289389,9302,792810000,767860000,24950000
2023-03-01,Nakhon Phanom ,east_northeast,0.726,62778,160173,151952,8221,252960000,232290000,20670000
2023-03-01,Bueng Kan ,east_northeast,0.5246999999999999,31939,65694,63625,2069,90390000,86400000,3990000
2023-03-01,Maha Sarakham ,east_northeast,0.5615,25931,195047,194152,895,135549999,133410000,2140000
2023-03-01,Loei ,east_northeast,0.5221,85354,141539,139224,2315,304080000,295770000,8310000
2023-03-01,Sakon Nakhon ,east_northeast,0.42060000000000003,47857,125565,124280,1285,170110000,166820000,3290000
2023-03-01,Nong Khai ,east_northeast,0.6716,87660,292031,202500,89531,506630000,301650000,204980000
2023-03-01,Nong Bua Lamphu ,east_northeast,0.2874,6863,23816,23644,172,17729999,17580000,150000
2023-03-01,Udon Thani ,east_northeast,0.6352,133260,366676,292242,74434,796450000,544240000,252210000
2023-03-01,Chaiyaphum ,east_northeast,0.48960000000000004,56473,103500,103043,457,141970000,140940000,1030000
2023-03-01,Nakhon Ratchasima ,east_northeast,0.6173,348421,595665,585411,10254,1025180000,993650000,31530000
2023-03-01,Buriram ,east_northeast,0.6987000000000001,134795,281889,278386,3503,569100000,558860000,10240000
2023-03-01,Mukdahan ,east_northeast,0.4379,34125,142831,133419,9412,210620000,188390000,22230000
2023-03-01,Yasothon ,east_northeast,0.39049999999999996,10390,37156,37016,140,36260000,36060000,200000
2023-03-01,Roi Et ,east_northeast,0.4682,28692,62037,61259,778,83899999,81850000,2050000
2023-03-01,Sisaket ,south,0.4334,22578,58939,58624,315,70029999,69320000,710000
2023-03-01,Surin ,east_northeast,0.46840000000000004,63083,86556,84335,2221,150540000,146190000,4350000
2023-03-01,Amnat Charoen ,east_northeast,0.33520000000000005,5747,19001,18587,414,21140000,20390000,750000
2023-03-01,Ubon Ratchathani ,east_northeast,0.4678,85901,274458,272968,1490,479330000,475960000,3370000
2023-04-01,Bangkok,central,0.795,2623630,4720294,2484713,2235581,58382060000,12764030000,45618030000
2023-04-01,Kanchanaburi ,central,0.631,292397,1242322,1217920,24402,2325900000,2250980000,74920000
2023-04-01,Nakhon Pathom ,central,0.462,70508,287880,284005,3875,389120000,379010000,10110000
2023-04-01,Prachuap Khiri Khan ,central,0.8035,533527,1022412,979422,42990,3733040000,3294990000,438050000
2023-04-01,Phetchaburi ,central,0.7331,359447,965527,952122,13405,2666640000,2612000000,54640000
2023-04-01,Ratchaburi ,central,0.5494,75047,207128,195788,11340,233830000,211080000,22750000
2023-04-01,Samut Prakan ,central,0.5077,78886,270538,196112,74426,390900000,273260000,117640000
2023-04-01,Samut Songkhram ,central,0.5535,57898,558236,543460,14776,522720000,502980000,19740000
2023-04-01,Samut Sakhon ,central,0.3691,25416,107519,106132,1387,149480000,146530000,2950000
2023-04-01,Chainat ,central,0.43799999999999994,16447,85805,85166,639,121490000,120810000,680000
2023-04-01,Nonthaburi ,central,0.5347,75738,294277,276648,17629,396190000,370610000,25580000
2023-04-01,Pathum Thani ,central,0.44789999999999996,32966,242032,220664,21368,343620000,314680000,28940000
2023-04-01,Phra Nakhon Si Ayutthaya ,central,0.5669,80232,815872,690797,125075,1335460000,1069930000,265530000
2023-04-01,Lopburi ,central,0.5321,65752,378898,377313,1585,479600000,477140000,2460000
2023-04-01,Saraburi ,central,0.6059,87810,360334,356663,3671,621770000,615880000,5890000
2023-04-01,Sing Buri ,central,0.423,13479,66141,65731,410,84800000,83940000,860000
2023-04-01,Suphan Buri ,central,0.5824,79471,565571,562335,3236,654530000,649790000,4740000
2023-04-01,Ang Thong ,central,0.4643,13271,97215,96590,625,119050000,118190000,860000
2023-04-01,Chanthaburi ,east,0.6983,116312,478266,475756,2510,1559790000,1554340000,5450000
2023-04-01,Chachoengsao ,east,0.3911,28820,475652,473803,1849,540370000,538490000,1880000
2023-04-01,Chonburi ,east,0.7806000000000001,1271633,2151568,1291317,860251,18671030000,7034810000,11636220000
2023-04-01,Trat ,east,0.6119,149977,192398,172466,19932,1240720000,1094670000,146050000
2023-04-01,Nakhon Nayok ,east,0.5769,85073,128398,127643,755,293380000,290940000,2440000
2023-04-01,Prachinburi ,east,0.4484,56325,106353,106021,332,293619999,292340000,1280000
2023-04-01,Rayong ,east,0.7503,261544,471715,392557,79158,1642560000,1410220000,232340000
2023-04-01,Sa Kaeo ,east,0.4435,35467,96598,95152,1446,317980000,314420000,3560000
2023-04-01,Krabi ,south,0.755,169403,368749,196916,171833,2684920000,1804420000,880500000
2023-04-01,Chumphon ,south,0.6084,97064,133574,132442,1132,324470000,321850000,2620000
2023-04-01,Nakhon Si Thammarat ,south,0.7073999999999999,185737,322573,318400,4173,742780000,731450000,11330000
2023-04-01,Phang Nga ,south,0.6812,78011,268743,99750,168993,1181750000,323210000,858540000
2023-04-01,Phuket ,south,0.8273,801620,986188,258066,728122,31337040000,1623200000,29713840000
2023-04-01,Ranong ,south,0.563,41920,65032,63389,1643,128710000,124530000,4180000
2023-04-01,Surat Thani ,south,0.7718,446176,693416,428436,264980,4799570000,2211080000,2588490000
2023-04-01,Trang ,south,0.6965,91363,151872,147366,4506,464570000,450930000,13640000
2023-04-01,Narathiwat ,south,0.5127,26593,70912,46108,24804,139310000,77090000,62220000
2023-04-01,Pattani ,south,0.4071,12609,25896,22158,3738,48600000,46990000,1610000
2023-04-01,Phatthalung ,south,0.6189,42457,111296,109813,1483,107730000,106500000,1230000
2023-04-01,Yala ,south,0.6625,72968,122713,73650,49063,260630000,122960000,137670000
2023-04-01,Songkhla ,south,0.7081999999999999,207679,393429,177678,215751,2197450000,940810000,1256640000
2023-04-01,Satun ,south,0.7247,101230,197328,180653,16675,802810000,746500000,56310000
2023-04-01,Chiang Rai ,north,0.6581999999999999,326520,547873,485390,62483,3948100000,3175990000,772110000
2023-04-01,Chiang Mai ,north,0.6966,546999,873671,667611,206060,6530580000,4541050000,1989530000
2023-04-01,Nan ,north,0.6934,94423,140671,139376,1295,375620000,367800000,7820000
2023-04-01,Phayao ,north,0.6351,41487,93160,89407,3753,208320000,196170000,12150000
2023-04-01,Phrae ,north,0.6183,47458,106436,105462,974,253510000,250780000,2730000
2023-04-01,Mae Hong Son ,north,0.4064,77969,91775,73419,18356,445610000,332650000,112960000
2023-04-01,Lampang ,north,0.5176,47797,128947,123301,5646,412180000,381890000,30290000
2023-04-01,Lamphun ,north,0.5014,18593,96964,90528,6436,138480000,123180000,15300000
2023-04-01,Kamphaeng Phet ,north,0.3382,31830,68477,66263,2214,132300000,127400000,4900000
2023-04-01,Tak ,north,0.6174000000000001,126397,181690,177095,4595,607680000,584770000,22910000
2023-04-01,Nakhon Sawan ,north,0.5693,88697,215460,214552,908,584400000,580780000,3620000
2023-04-01,Phichit ,north,0.47340000000000004,29361,64924,64796,128,117540000,117200000,340000
2023-04-01,Phitsanulok ,north,0.4608,119109,240892,230030,10862,662700000,627840000,34860000
2023-04-01,Phetchabun ,north,0.4073,153649,215537,210065,5472,737630000,715170000,22460000
2023-04-01,Sukhothai ,north,0.2965,43965,98513,83360,15153,251390000,201330000,50060000
2023-04-01,Uttaradit ,north,0.4296,47635,89820,89306,514,146179999,144760000,1420000
2023-04-01,Uthai Thani ,north,0.5012,28116,83514,83434,80,139059999,138890000,170000
2023-04-01,Kalasin ,east_northeast,0.5783,26147,89347,86777,2570,127700000,119410000,8289999
2023-04-01,Khon Kaen ,east_northeast,0.5879,156421,352937,342351,10586,948720000,919590000,29130000
2023-04-01,Nakhon Phanom ,east_northeast,0.7422,65024,176310,165930,10380,287750000,260780000,26970000
2023-04-01,Bueng Kan ,east_northeast,0.5347999999999999,32530,72002,69338,2664,99730000,94480000,5250000
2023-04-01,Maha Sarakham ,east_northeast,0.5344,24871,128340,127311,1029,91640000,89150000,2490000
2023-04-01,Loei ,east_northeast,0.5427000000000001,87618,147145,144589,2556,320510000,311100000,9410000
2023-04-01,Sakon Nakhon ,east_northeast,0.4164,45690,126977,125592,1385,176580000,172970000,3610000
2023-04-01,Nong Khai ,east_northeast,0.6922,89571,305263,209297,95966,538220000,314400000,223820000
2023-04-01,Nong Bua Lamphu ,east_northeast,0.3126,7125,24372,24116,256,19190000,18950000,240000
2023-04-01,Udon Thani ,east_northeast,0.6574,137049,404621,313764,90857,916700000,602920000,313780000
2023-04-01,Chaiyaphum ,east_northeast,0.5214,60076,137254,136729,525,186150000,184910000,1240000
2023-04-01,Nakhon Ratchasima ,east_northeast,0.6431,357844,612741,601474,11267,1081360000,1045950000,35410000
2023-04-01,Buriram ,east_northeast,0.7358,140900,297965,294076,3889,615920000,604430000,11490000
2023-04-01,Mukdahan ,east_northeast,0.42719999999999997,32797,140464,129416,11048,211990000,185700000,26290000
2023-04-01,Yasothon ,east_northeast,0.4014,10565,40625,40462,163,40230000,39990000,240000
2023-04-01,Roi Et ,east_northeast,0.45439999999999997,27570,65246,64164,1082,90160000,87300000,2860000
2023-04-01,Sisaket ,south,0.473,25977,64607,64262,345,80820000,80060000,760000
2023-04-01,Surin ,east_northeast,0.4816,64682,91004,88326,2678,159250000,153950000,5300000
2023-04-01,Amnat Charoen ,east_northeast,0.3283,5525,19907,19434,473,23200000,22310000,890000
2023-04-01,Ubon Ratchathani ,east_northeast,0.4826,88958,291060,289319,1741,518370000,514370000,4000000
2023-05-01,Bangkok,central,0.7365,2520812,4566493,2433065,2133428,56203870000,12274820000,43929050000
2023-05-01,Kanchanaburi ,central,0.6008,273415,1161569,1136034,25535,2153100000,2073970000,79130000
2023-05-01,Nakhon Pathom ,central,0.44420000000000004,68573,274917,271613,3304,366900000,358450000,8450000
2023-05-01,Prachuap Khiri Khan ,central,0.7121,455955,872912,834637,38275,3167140000,2781070000,386070000
2023-05-01,Phetchaburi ,central,0.6648000000000001,327493,887566,874977,12589,2441640000,2390180000,51460000
2023-05-01,Ratchaburi ,central,0.5047,70905,194758,185327,9431,216200000,197940000,18260000
2023-05-01,Samut Prakan ,central,0.4783,76332,253595,182308,71287,362710000,251650000,111060000
2023-05-01,Samut Songkhram ,central,0.5647,60593,561883,547744,14139,530160000,511430000,18730000
2023-05-01,Samut Sakhon ,central,0.3776,26740,95696,94701,995,135140000,133010000,2130000
2023-05-01,Chainat ,central,0.445,17491,79914,79478,436,112520000,112050000,470000
2023-05-01,Nonthaburi ,central,0.5556,79629,288778,271799,16979,386780000,361610000,25170000
2023-05-01,Pathum Thani ,central,0.46159999999999995,35099,232979,213963,19016,325580000,299160000,26420000
2023-05-01,Phra Nakhon Si Ayutthaya ,central,0.5177,73573,777555,660079,117476,1254090000,1011250000,242840000
2023-05-01,Lopburi ,central,0.49729999999999996,61134,331405,330149,1256,418520000,416580000,1940000
2023-05-01,Saraburi ,central,0.5793,83236,329942,326969,2973,560770000,556070000,4700000
2023-05-01,Sing Buri ,central,0.45640000000000003,14656,64563,63982,581,82470000,81280000,1190000
2023-05-01,Suphan Buri ,central,0.5538000000000001,75210,538286,535617,2669,608900000,605060000,3840000
2023-05-01,Ang Thong ,central,0.42950000000000005,12438,87099,86510,589,106510000,105730000,780000
2023-05-01,Chanthaburi ,east,0.6238,107472,445344,443403,1941,1440520000,1436420000,4100000
2023-05-01,Chachoengsao ,east,0.3826,27907,449040,447436,1604,505790000,504170000,1620000
2023-05-01,Chonburi ,east,0.7249,1155652,1838511,1035047,803464,17411680000,6715510000,10696170000
2023-05-01,Trat ,east,0.5524,139818,179812,162382,17430,1157150000,1031400000,125750000
2023-05-01,Nakhon Nayok ,east,0.5535,83867,126529,125825,704,287310000,285080000,2230000
2023-05-01,Prachinburi ,east,0.4567,57576,111476,111169,307,303770000,302590000,1180000
2023-05-01,Rayong ,east,0.8024,273351,491071,414277,76794,1694199999,1469340000,224860000
2023-05-01,Sa Kaeo ,east,0.4363,35313,96239,94888,1351,315720000,312400000,3320000
2023-05-01,Krabi ,south,0.6722,153200,326769,187403,139366,2396910000,1736030000,660880000
2023-05-01,Chumphon ,south,0.5792,96071,128110,127113,997,327180000,324740000,2440000
2023-05-01,Nakhon Si Thammarat ,south,0.6651,181021,317995,314015,3980,710900000,700220000,10680000
2023-05-01,Phang Nga ,south,0.6487,76485,256881,103364,153517,1113010000,332450000,780560000
2023-05-01,Phuket ,south,0.7323000000000001,726575,886730,227217,659513,28381160000,1494610000,26886550000
2023-05-01,Ranong ,south,0.5428000000000001,41549,60307,58818,1489,125770000,121730000,4040000
2023-05-01,Surat Thani ,south,0.7044,420684,625135,375849,249286,4328840000,1825990000,2502850000
2023-05-01,Trang ,south,0.6587999999999999,81635,138526,134655,3871,422950000,411580000,11370000
2023-05-01,Narathiwat ,south,0.49950000000000006,26454,33931,19714,14217,76390000,34300000,42090000
2023-05-01,Pattani ,south,0.441,14250,27038,23123,3915,51000000,49320000,1680000
2023-05-01,Phatthalung ,south,0.6074,42284,115800,114325,1475,110990000,109710000,1280000
2023-05-01,Yala ,south,0.6364,71153,116450,69216,47234,247330000,115330000,132000000
2023-05-01,Songkhla ,south,0.6645,200532,387000,185684,201316,2113870000,973040000,1140830000
2023-05-01,Satun ,south,0.6159,88939,186020,170454,15566,747770000,696120000,51650000
2023-05-01,Chiang Rai ,north,0.6657,333476,472310,420618,51692,3433610000,2791190000,642420000
2023-05-01,Chiang Mai ,north,0.6872,544487,805788,592072,213716,6154290000,4071860000,2082430000
2023-05-01,Nan ,north,0.6783,93958,133089,131757,1332,362450000,354320000,8130000
2023-05-01,Phayao ,north,0.6034,40800,73321,70586,2735,168590000,159490000,9100000
2023-05-01,Phrae ,north,0.5825,46545,94688,93765,923,229580000,226950000,2630000
2023-05-01,Mae Hong Son ,north,0.3602,75095,86049,68762,17287,422870000,315190000,107680000
2023-05-01,Lampang ,north,0.5032,47527,108983,103898,5085,357580000,329880000,27700000
2023-05-01,Lamphun ,north,0.4874,18497,92836,87207,5629,135000000,121390000,13610000
2023-05-01,Kamphaeng Phet ,north,0.35479999999999995,32621,64463,62224,2239,128310000,123200000,5110000
2023-05-01,Tak ,north,0.6083,125711,177240,173149,4091,600690000,579930000,20760000
2023-05-01,Nakhon Sawan ,north,0.4802,82056,192560,191567,993,533640000,529600000,4040000
2023-05-01,Phichit ,north,0.4656,29217,60724,60589,135,113190000,112820000,370000
2023-05-01,Phitsanulok ,north,0.4769,122285,237169,226971,10198,658300000,625040000,33260000
2023-05-01,Phetchabun ,north,0.3604,148327,192437,188016,4421,666870000,648440000,18430000
2023-05-01,Sukhothai ,north,0.2651,42843,86843,73278,13565,227410000,181570000,45840000
2023-05-01,Uttaradit ,north,0.40740000000000004,47132,78613,78187,426,131720000,130520000,1200000
2023-05-01,Uthai Thani ,north,0.5167,28919,75464,75370,94,129830000,129620000,210000
2023-05-01,Kalasin ,east_northeast,0.5522,25795,73920,71892,2028,100690000,94230000,6460000
2023-05-01,Khon Kaen ,east_northeast,0.5571,153071,312441,304327,8114,835580000,813440000,22140000
2023-05-01,Nakhon Phanom ,east_northeast,0.7575,66170,178508,170885,7623,271620000,251120000,20500000
2023-05-01,Bueng Kan ,east_northeast,0.5085000000000001,31821,70607,68261,2346,97390000,92980000,4410000
2023-05-01,Maha Sarakham ,east_northeast,0.5072,24224,44306,43368,938,44590000,42430000,2160000
2023-05-01,Loei ,east_northeast,0.5324,86731,144068,141750,2318,309260000,300810000,8450000
2023-05-01,Sakon Nakhon ,east_northeast,0.4293,47857,121481,120480,1001,154940000,152340000,2600000
2023-05-01,Nong Khai ,east_northeast,0.6576000000000001,85474,257862,187649,70213,433320000,276000000,157320000
2023-05-01,Nong Bua Lamphu ,east_northeast,0.4072,8146,24753,24518,235,19410000,19190000,220000
2023-05-01,Udon Thani ,east_northeast,0.6329,132463,338075,260804,77271,761900000,496090000,265810000
2023-05-01,Chaiyaphum ,east_northeast,0.5019,58666,123680,123202,478,166140000,165040000,1100000
2023-05-01,Nakhon Ratchasima ,east_northeast,0.6214,352802,597080,587456,9624,1049320000,1019250000,30070000
2023-05-01,Buriram ,east_northeast,0.7016,136044,269897,267621,2276,546339999,540430000,5910000
2023-05-01,Mukdahan ,east_northeast,0.40869999999999995,32441,127571,118737,8834,186530000,165730000,20800000
2023-05-01,Yasothon ,east_northeast,0.42479999999999996,11010,43266,43113,153,43920000,43700000,220000
2023-05-01,Roi Et ,east_northeast,0.4313,26726,62383,61397,986,84490000,81980000,2510000
2023-05-01,Sisaket ,south,0.4054,23483,55256,54934,322,67970000,67270000,700000
2023-05-01,Surin ,east_northeast,0.46090000000000003,63277,87980,85666,2314,153390000,148980000,4410000
2023-05-01,Amnat Charoen ,east_northeast,0.3264,5457,18893,18447,446,21570000,20760000,810000
2023-05-01,Ubon Ratchathani ,east_northeast,0.4679,86815,207729,206159,1570,365810000,362340000,3470000
2023-06-01,Bangkok,central,0.7689,2591923,4530923,2380154,2150769,57046330000,11748870000,45297460000
2023-06-01,Kanchanaburi ,central,0.5667,258766,1123255,1098944,24311,2118920000,2042490000,76430000
2023-06-01,Nakhon Pathom ,central,0.4715,72214,286508,282335,4173,388560000,378120000,10440000
2023-06-01,Prachuap Khiri Khan ,central,0.6639,431788,829375,788519,40856,3019760000,2608200000,411560000
2023-06-01,Phetchaburi ,central,0.6185,302445,845755,834624,11131,2352140000,2305950000,46190000
2023-06-01,Ratchaburi ,central,0.5297999999999999,73812,189682,179856,9826,214410000,195160000,19250000
2023-06-01,Samut Prakan ,central,0.4717,76264,250509,176619,73890,356720000,240240000,116480000
2023-06-01,Samut Songkhram ,central,0.5479999999999999,57219,543151,529378,13773,515420000,496970000,18450000
2023-06-01,Samut Sakhon ,central,0.3932,28267,99334,98601,733,141060000,139480000,1580000
2023-06-01,Chainat ,central,0.4841,18425,86042,85507,535,122780000,122200000,580000
2023-06-01,Nonthaburi ,central,0.5886,83476,298440,281006,17434,405290000,379040000,26250000
2023-06-01,Pathum Thani ,central,0.49729999999999996,40059,248037,229278,18759,350900000,324840000,26060000
2023-06-01,Phra Nakhon Si Ayutthaya ,central,0.5390999999999999,76046,804279,682876,121403,1316639999,1064080000,252560000
2023-06-01,Lopburi ,central,0.511,62746,335876,334954,922,430080000,428640000,1440000
2023-06-01,Saraburi ,central,0.5522,80155,323575,320834,2741,531130000,526720000,4410000
2023-06-01,Sing Buri ,central,0.4278,13314,59228,58754,474,76700000,75720000,980000
2023-06-01,Suphan Buri ,central,0.5694,75991,549660,547199,2461,630060000,626400000,3660000
2023-06-01,Ang Thong ,central,0.4127,11572,84446,83779,667,103480000,102580000,900000
2023-06-01,Chanthaburi ,east,0.5554,97998,404189,402443,1746,1293390000,1289720000,3670000
2023-06-01,Chachoengsao ,east,0.34729999999999994,25551,433512,432119,1393,483260000,481860000,1400000
2023-06-01,Chonburi ,east,0.7433,1189666,1883499,1076202,807297,17793640000,7010180000,10783460000
2023-06-01,Trat ,east,0.4964,126150,142274,127663,14611,901490000,797930000,103560000
2023-06-01,Nakhon Nayok ,east,0.5652,85392,134243,133586,657,315490000,313410000,2080000
2023-06-01,Prachinburi ,east,0.4362,55629,108174,107889,285,294099999,293010000,1090000
2023-06-01,Rayong ,east,0.7413,260500,429348,364428,64920,1472600000,1284240000,188360000
2023-06-01,Sa Kaeo ,east,0.4152,34789,94877,93578,1299,297830000,294630000,3200000
2023-06-01,Krabi ,south,0.6401,141016,306508,170544,135964,2221290000,1575600000,645690000
2023-06-01,Chumphon ,south,0.547,87699,123610,122496,1114,314870000,312110000,2760000
2023-06-01,Nakhon Si Thammarat ,south,0.6769,183219,327845,323754,4091,727010000,716060000,10950000
2023-06-01,Phang Nga ,south,0.5885,67146,241758,90538,151220,1068340000,291880000,776460000
2023-06-01,Phuket ,south,0.7101999999999999,694762,855642,212453,643189,27637790000,1454450000,26183340000
2023-06-01,Ranong ,south,0.5134000000000001,38016,55651,54194,1457,116450000,112510000,3940000
2023-06-01,Surat Thani ,south,0.6919,399462,597912,351712,246200,4179830000,1707270000,2472560000
2023-06-01,Trang ,south,0.4596,54826,98380,95427,2953,298580000,289940000,8640000
2023-06-01,Narathiwat ,south,0.5323,27217,41406,24304,17102,92240000,42140000,50100000
2023-06-01,Pattani ,south,0.4685,14914,31263,26600,4663,58290000,56280000,2010000
2023-06-01,Phatthalung ,south,0.621,41843,117669,116029,1640,113060000,111630000,1430000
2023-06-01,Yala ,south,0.6686,72333,128687,77099,51588,281550000,136860000,144690000
2023-06-01,Songkhla ,south,0.6979000000000001,203854,416949,193311,223638,2265760000,1013140000,1252620000
2023-06-01,Satun ,south,0.5907,82584,174610,158032,16578,710350000,656600000,53750000
2023-06-01,Chiang Rai ,north,0.6079,295672,400315,350499,49816,2979149999,2356720000,622430000
2023-06-01,Chiang Mai ,north,0.6686,538043,715979,519301,196678,5602590000,3651740000,1950850000
2023-06-01,Nan ,north,0.6314,77798,108905,107834,1071,300909999,294280000,6630000
2023-06-01,Phayao ,north,0.5649000000000001,37570,65586,63152,2434,152550000,144360000,8189999
2023-06-01,Phrae ,north,0.5987,45574,91598,90718,880,223990000,221450000,2540000
2023-06-01,Mae Hong Son ,north,0.3906,80648,89583,71862,17721,443230000,332170000,111060000
2023-06-01,Lampang ,north,0.4855,47173,101583,96845,4738,339880000,313780000,26100000
2023-06-01,Lamphun ,north,0.47090000000000004,18390,90524,85374,5150,132680000,119930000,12750000
2023-06-01,Kamphaeng Phet ,north,0.32939999999999997,29981,60776,58641,2135,123640000,118700000,4940000
2023-06-01,Tak ,north,0.5740999999999999,115526,164057,160704,3353,564430000,547220000,17210000
2023-06-01,Nakhon Sawan ,north,0.4526,75094,177907,176931,976,498110000,494100000,4010000
2023-06-01,Phichit ,north,0.4561,27721,57901,57779,122,109650000,109310000,340000
2023-06-01,Phitsanulok ,north,0.46340000000000003,116587,224293,214550,9743,630760000,598560000,32200000
2023-06-01,Phetchabun ,north,0.36829999999999996,134994,169298,165830,3468,593510000,578900000,14610000
2023-06-01,Sukhothai ,north,0.25489999999999996,38786,80296,67534,12762,212880000,169010000,43870000
2023-06-01,Uttaradit ,north,0.4125,42664,69908,69588,320,119060000,118140000,920000
2023-06-01,Uthai Thani ,north,0.4963,26400,70323,70243,80,121870000,121680000,190000
2023-06-01,Kalasin ,east_northeast,0.5367999999999999,25133,68183,66260,1923,92680000,86620000,6060000
2023-06-01,Khon Kaen ,east_northeast,0.5304,143515,293408,285679,7729,760970000,740100000,20870000
2023-06-01,Nakhon Phanom ,east_northeast,0.787,68830,185269,177313,7956,286280000,264030000,22250000
2023-06-01,Bueng Kan ,east_northeast,0.5276,32741,72574,70312,2262,98290000,94060000,4230000
2023-06-01,Maha Sarakham ,east_northeast,0.48090000000000005,22722,35884,35049,835,42750000,40740000,2010000
2023-06-01,Loei ,east_northeast,0.7648,122621,260379,257782,2597,560370000,550760000,9610000
2023-06-01,Sakon Nakhon ,east_northeast,0.4169,46514,117920,116929,991,155360000,152800000,2560000
2023-06-01,Nong Khai ,east_northeast,0.6343,82590,248993,181357,67636,416840000,265820000,151020000
2023-06-01,Nong Bua Lamphu ,east_northeast,0.4354,8674,26280,26075,205,20960000,20770000,190000
2023-06-01,Udon Thani ,east_northeast,0.6191,127944,326731,250280,76451,740880000,478880000,262000000
2023-06-01,Chaiyaphum ,east_northeast,0.5334,61157,130208,129723,485,175570000,174450000,1120000
2023-06-01,Nakhon Ratchasima ,east_northeast,0.6003000000000001,332541,563763,554588,9175,982060000,953420000,28640000
2023-06-01,Buriram ,east_northeast,0.6738,128394,254708,252495,2213,504490000,498940000,5550000
2023-06-01,Mukdahan ,east_northeast,0.3962,32283,129133,120005,9128,187660000,165780000,21880000
2023-06-01,Yasothon ,east_northeast,0.4117,10695,48385,48225,160,44760000,44510000,250000
2023-06-01,Roi Et ,east_northeast,0.4146,25511,59561,58597,964,78830000,76380000,2450000
2023-06-01,Sisaket ,south,0.4409,26475,78079,77738,341,96030000,95280000,750000
2023-06-01,Surin ,east_northeast,0.45289999999999997,61308,85330,83084,2246,147149999,142950000,4200000
2023-06-01,Amnat Charoen ,east_northeast,0.3091,5268,18285,17852,433,20720000,19950000,770000
2023-06-01,Ubon Ratchathani ,east_northeast,0.45799999999999996,83088,199351,197825,1526,347770000,344450000,3320000
2023-07-01,Bangkok,central,0.7804000000000001,2693375,4634035,2462967,2171068,59404640000,12330850000,47073790000
2023-07-01,Kanchanaburi ,central,0.6053999999999999,264874,1140366,1116534,23832,2184529999,2108540000,75990000
2023-07-01,Nakhon Pathom ,central,0.4536,67249,277738,274305,3433,354930000,346000000,8930000
2023-07-01,Prachuap Khiri Khan ,central,0.6834,443311,844130,799965,44165,3114899999,2670430000,444470000
2023-07-01,Phetchaburi ,central,0.6426999999999999,312095,861856,849235,12621,2426460000,2374480000,51980000
2023-07-01,Ratchaburi ,central,0.5181,72474,186731,178859,7872,209540000,193820000,15720000
2023-07-01,Samut Prakan ,central,0.4936,82182,252850,182920,69930,363130000,251880000,111250000
2023-07-01,Samut Songkhram ,central,0.5642,61395,537181,523995,13186,506620000,488810000,17810000
2023-07-01,Samut Sakhon ,central,0.43189999999999995,32142,103468,102811,657,148390000,146960000,1430000
2023-07-01,Chainat ,central,0.5078,19822,92374,91782,592,132840000,132180000,660000
2023-07-01,Nonthaburi ,central,0.5957,87314,312312,295366,16946,421380000,395540000,25840000
2023-07-01,Pathum Thani ,central,0.4999,41634,245458,227298,18160,348159999,322380000,25780000
2023-07-01,Phra Nakhon Si Ayutthaya ,central,0.5684,80728,817435,688886,128549,1340699999,1076620000,264080000
2023-07-01,Lopburi ,central,0.47509999999999997,58516,326280,325500,780,409670000,408400000,1270000
2023-07-01,Saraburi ,central,0.5027,75143,329659,327108,2551,554600000,550400000,4200000
2023-07-01,Sing Buri ,central,0.4797,15395,63823,63302,521,83060000,81980000,1080000
2023-07-01,Suphan Buri ,central,0.5261,68164,530159,528189,1970,611100000,608080000,3020000
2023-07-01,Ang Thong ,central,0.4454,12330,88512,87847,665,109540000,108650000,890000
2023-07-01,Chanthaburi ,east,0.5271,96122,374851,373552,1299,1197050000,1194420000,2630000
2023-07-01,Chachoengsao ,east,0.3746,27475,456729,455077,1652,510730000,509060000,1670000
2023-07-01,Chonburi ,east,0.7887000000000001,1260591,1956748,1123518,833230,18334150000,7263980000,11070170000
2023-07-01,Trat ,east,0.4796,125916,139008,117522,21486,872880000,723440000,149440000
2023-07-01,Nakhon Nayok ,east,0.6018,91843,157555,156715,840,374990000,372340000,2650000
2023-07-01,Prachinburi ,east,0.42369999999999997,55448,103876,103639,237,279950000,279070000,880000
2023-07-01,Rayong ,east,0.757,262816,435637,369272,66365,1498430000,1303190000,195240000
2023-07-01,Sa Kaeo ,east,0.4299,36238,99510,98082,1428,304729999,301140000,3590000
2023-07-01,Krabi ,south,0.6192,140968,299634,170202,129432,2159340000,1571870000,587470000
2023-07-01,Chumphon ,south,0.5534,92227,132556,130603,1953,335470000,330590000,4880000
2023-07-01,Nakhon Si Thammarat ,south,0.6842,191374,345817,341344,4473,770470000,758900000,11570000
2023-07-01,Phang Nga ,south,0.5686,67023,238471,89420,149051,1062630000,290900000,771730000
2023-07-01,Phuket ,south,0.731,738877,922065,265628,656437,28024020000,1767880000,26256140000
2023-07-01,Ranong ,south,0.4976,36989,54346,52946,1400,114100000,110460000,3640000
2023-07-01,Surat Thani ,south,0.7014,418637,627620,377763,249857,4521170000,2031000000,2490170000
2023-07-01,Trang ,south,0.46619999999999995,57501,102834,99152,3682,307710000,297460000,10250000
2023-07-01,Narathiwat ,south,0.562,29718,52259,27445,24814,123420000,49110000,74310000
2023-07-01,Pattani ,south,0.4851,15959,38671,30761,7910,65200000,61950000,3250000
2023-07-01,Phatthalung ,south,0.627,43653,121412,119160,2252,116490000,114780000,1710000
2023-07-01,Yala ,south,0.7012,78379,141048,86118,54930,300740000,151980000,148760000
2023-07-01,Songkhla ,south,0.6773,203020,363438,189521,173917,1938940000,958640000,980300000
2023-07-01,Satun ,south,0.581,82469,169987,153663,16324,687250000,633600000,53650000
2023-07-01,Chiang Rai ,north,0.6103999999999999,303309,418354,364171,54183,3144730000,2463870000,680860000
2023-07-01,Chiang Mai ,north,0.6970999999999999,569424,780496,569501,210995,6155740000,4046560000,2109180000
2023-07-01,Nan ,north,0.6489,77184,112898,111764,1134,308440000,301320000,7120000
2023-07-01,Phayao ,north,0.523,33649,68585,66205,2380,160590000,152470000,8119999
2023-07-01,Phrae ,north,0.5574,40423,92413,91476,937,230460000,227700000,2760000
2023-07-01,Mae Hong Son ,north,0.4428,80240,91183,71318,19865,458830000,332800000,126030000
2023-07-01,Lampang ,north,0.5439,51317,117925,112459,5466,388210000,357740000,30470000
2023-07-01,Lamphun ,north,0.4986,19357,107693,102106,5587,161360000,147230000,14130000
2023-07-01,Kamphaeng Phet ,north,0.3172,29807,62593,60544,2049,128880000,124040000,4840000
2023-07-01,Tak ,north,0.5867,119665,170301,166856,3445,576490000,558600000,17890000
2023-07-01,Nakhon Sawan ,north,0.4692,77604,181210,180149,1061,515500000,511060000,4440000
2023-07-01,Phichit ,north,0.4379,27517,59721,59604,117,114680000,114350000,330000
2023-07-01,Phitsanulok ,north,0.49060000000000004,121744,234560,223829,10731,669330000,633240000,36090000
2023-07-01,Phetchabun ,north,0.4129,143644,179774,176110,3664,637870000,622290000,15580000
2023-07-01,Sukhothai ,north,0.3094,42174,85504,71412,14092,230410000,181260000,49150000
2023-07-01,Uttaradit ,north,0.4326,44278,76714,76360,354,132790000,131750000,1040000
2023-07-01,Uthai Thani ,north,0.5019,26882,76908,76823,85,129030000,128820000,210000
2023-07-01,Kalasin ,east_northeast,0.5126,24437,68052,66154,1898,92040000,86120000,5920000
2023-07-01,Khon Kaen ,east_northeast,0.5444,149993,309290,301061,8229,814920000,792260000,22660000
2023-07-01,Nakhon Phanom ,east_northeast,0.7935,70602,193910,185582,8328,305720000,282110000,23610000
2023-07-01,Bueng Kan ,east_northeast,0.5387,33727,74670,72333,2337,101550000,97150000,4400000
2023-07-01,Maha Sarakham ,east_northeast,0.4979,23764,38705,37851,854,46130000,44070000,2060000
2023-07-01,Loei ,east_northeast,0.6909000000000001,112863,190768,188169,2599,410500000,400800000,9700000
2023-07-01,Sakon Nakhon ,east_northeast,0.4629,48674,129782,128761,1021,181650000,178990000,2660000
2023-07-01,Nong Khai ,east_northeast,0.6462,85406,253629,183877,69752,428780000,273020000,155760000
2023-07-01,Nong Bua Lamphu ,east_northeast,0.4169,8347,25908,25720,188,20430000,20260000,170000
2023-07-01,Udon Thani ,east_northeast,0.6396999999999999,133594,359211,278866,80345,799500000,523320000,276180000
2023-07-01,Chaiyaphum ,east_northeast,0.7098,82124,188892,188375,517,258950000,257700000,1250000
2023-07-01,Nakhon Ratchasima ,east_northeast,0.6769,378785,629482,617936,11546,1209080000,1172200000,36880000
2023-07-01,Buriram ,east_northeast,0.6862,132959,260461,258062,2399,522750000,516630000,6120000
2023-07-01,Mukdahan ,east_northeast,0.38549999999999995,31254,124699,115834,8865,178190000,158330000,19860000
2023-07-01,Yasothon ,east_northeast,0.3933,10398,41490,41344,146,40210000,39990000,220000
2023-07-01,Roi Et ,east_northeast,0.4307,26294,61138,60138,1000,81000000,78420000,2580000
2023-07-01,Sisaket ,south,0.485,28023,85401,85026,375,106310000,105360000,950000
2023-07-01,Surin ,east_northeast,0.43700000000000006,59975,81500,79338,2162,138910000,134880000,4030000
2023-07-01,Amnat Charoen ,east_northeast,0.3189,5472,19130,18666,464,21770000,20960000,810000
2023-07-01,Ubon Ratchathani ,east_northeast,0.4854,88653,218415,216799,1616,394580000,391020000,3560000
2023-08-01,Bangkok,central,0.7831,2787521,4698658,2483588,2215070,61013630000,12601910000,48411720000
2023-08-01,Kanchanaburi ,central,0.6837000000000001,287382,1195498,1165671,29827,2319900000,2227250000,92650000
2023-08-01,Nakhon Pathom ,central,0.5197999999999999,79303,323483,319685,3798,417280000,407120000,10160000
2023-08-01,Prachuap Khiri Khan ,central,0.6586,428039,858158,817207,40951,3483370000,3026960000,456410000
2023-08-01,Phetchaburi ,central,0.6374,306437,866703,853314,13389,2557569999,2488100000,69470000
2023-08-01,Ratchaburi ,central,0.5387,75883,193460,185168,8292,284169999,266780000,17390000
2023-08-01,Samut Prakan ,central,0.5129,85295,269995,202990,67005,394130000,283190000,110940000
2023-08-01,Samut Songkhram ,central,0.5478000000000001,60051,545978,533622,12356,520030000,503070000,16960000
2023-08-01,Samut Sakhon ,central,0.415,31015,108309,107822,487,157100000,156000000,1100000
2023-08-01,Chainat ,central,0.4853,18941,88466,87982,484,127780000,127230000,550000
2023-08-01,Nonthaburi ,central,0.5971,87461,331529,314444,17085,454390000,427680000,26710000
2023-08-01,Pathum Thani ,central,0.5011,41764,259732,240467,19265,370070000,342450000,27620000
2023-08-01,Phra Nakhon Si Ayutthaya ,central,0.5644,79840,892507,745088,147419,1610100000,1252260000,357840000
2023-08-01,Lopburi ,central,0.46759999999999996,56738,340632,339695,937,426830000,425270000,1560000
2023-08-01,Saraburi ,central,0.5294,77879,353221,349868,3353,597360000,591750000,5610000
2023-08-01,Sing Buri ,central,0.5051,16187,68061,67620,441,89980000,89060000,920000
2023-08-01,Suphan Buri ,central,0.5276,68352,541650,539462,2188,631050000,627630000,3420000
2023-08-01,Ang Thong ,central,0.4558,12645,91029,90272,757,115720000,114650000,1070000
2023-08-01,Chanthaburi ,east,0.5385,98108,377792,376329,1463,1207890000,1204910000,2980000
2023-08-01,Chachoengsao ,east,0.3926,28800,462239,460750,1489,518380000,516850000,1530000
2023-08-01,Chonburi ,east,0.8059000000000001,1287723,1998421,1159016,839405,18750070000,7559090000,11190980000
2023-08-01,Trat ,east,0.4415,119795,133243,110948,22295,823829999,668660000,155170000
2023-08-01,Nakhon Nayok ,east,0.6139,93705,162447,161295,1152,387180000,383440000,3740000
2023-08-01,Prachinburi ,east,0.44020000000000004,57564,107394,106740,654,290510000,288060000,2450000
2023-08-01,Rayong ,east,0.7676000000000001,266510,441195,371766,69429,1517790000,1312360000,205430000
2023-08-01,Sa Kaeo ,east,0.4753,38579,105509,103928,1581,325479999,321340000,4140000
2023-08-01,Krabi ,south,0.6399,145665,311957,176765,135192,2382420000,1632610000,749810000
2023-08-01,Chumphon ,south,0.5462,90981,132026,129963,2063,332590000,327420000,5170000
2023-08-01,Nakhon Si Thammarat ,south,0.6945,194207,350226,345539,4687,781089999,768920000,12170000
2023-08-01,Phang Nga ,south,0.5249,61877,230585,87838,142747,1080610000,286070000,794540000
2023-08-01,Phuket ,south,0.735,761602,946418,264061,682357,32345450000,1962480000,30382970000
2023-08-01,Ranong ,south,0.5203,38691,56850,55341,1509,119450000,115570000,3880000
2023-08-01,Surat Thani ,south,0.72,429624,643311,365542,277769,5420900000,2226010000,3194890000
2023-08-01,Trang ,south,0.4517,55676,100205,96638,3567,305500000,295620000,9880000
2023-08-01,Narathiwat ,south,0.5821999999999999,33790,58770,27966,30804,146200000,49780000,96420000
2023-08-01,Pattani ,south,0.5232,17214,44955,32244,12711,69149999,63940000,5210000
2023-08-01,Phatthalung ,south,0.6473,45078,123933,121563,2370,118980000,117190000,1790000
2023-08-01,Yala ,south,0.7508,83933,153487,92290,61197,326960000,162050000,164910000
2023-08-01,Songkhla ,south,0.6999,230810,401218,213436,187782,2254050000,1090750000,1163300000
2023-08-01,Satun ,south,0.613,87051,177584,160042,17542,842210000,777610000,64599999
2023-08-01,Chiang Rai ,north,0.6182,300996,427845,371903,55942,3223000000,2527340000,695660000
2023-08-01,Chiang Mai ,north,0.6922,531902,724883,505548,219335,5868459999,3646720000,2221740000
2023-08-01,Nan ,north,0.6436,75629,107723,106681,1042,304060000,297570000,6490000
2023-08-01,Phayao ,north,0.5388000000000001,36542,70424,68085,2339,167670000,159640000,8029999
2023-08-01,Phrae ,north,0.5834,44872,97389,96262,1127,242780000,239410000,3370000
2023-08-01,Mae Hong Son ,north,0.46509999999999996,81773,89051,69254,19797,452620000,324220000,128400000
2023-08-01,Lampang ,north,0.5359,51183,128574,122790,5784,427150000,395590000,31560000
2023-08-01,Lamphun ,north,0.5091,20423,108696,104335,4361,160130000,149350000,10780000
2023-08-01,Kamphaeng Phet ,north,0.3214,29316,63541,61796,1745,131680000,127480000,4200000
2023-08-01,Tak ,north,0.5946,120026,163579,160495,3084,557790000,542010000,15780000
2023-08-01,Nakhon Sawan ,north,0.48729999999999996,80496,176840,175724,1116,509830000,505230000,4600000
2023-08-01,Phichit ,north,0.4604,28586,63239,63110,129,119320000,118960000,360000
2023-08-01,Phitsanulok ,north,0.4984,123691,229676,220031,9645,663350000,630530000,32820000
2023-08-01,Phetchabun ,north,0.4596,149274,184880,182156,2724,662440000,650960000,11480000
2023-08-01,Sukhothai ,north,0.3218,43001,92726,71940,20786,257270000,184400000,72870000
2023-08-01,Uttaradit ,north,0.4254,43759,79287,78917,370,138460000,137400000,1060000
2023-08-01,Uthai Thani ,north,0.4736,26569,82915,82802,113,142880000,142600000,280000
2023-08-01,Kalasin ,east_northeast,0.49340000000000006,23503,65448,63620,1828,88140000,82490000,5650000
2023-08-01,Khon Kaen ,east_northeast,0.5412,148798,305808,298156,7652,807400000,786450000,20950000
2023-08-01,Nakhon Phanom ,east_northeast,0.7796,69191,188531,180437,8094,288990000,266980000,22010000
2023-08-01,Bueng Kan ,east_northeast,0.5189,32507,72252,70171,2081,97380000,93470000,3910000
2023-08-01,Maha Sarakham ,east_northeast,0.4814,22539,35398,34588,810,42670000,40750000,1920000
2023-08-01,Loei ,east_northeast,0.7023,114841,193955,191391,2564,418980000,409310000,9670000
2023-08-01,Sakon Nakhon ,east_northeast,0.4461,46986,112766,111938,828,150040000,147670000,2370000
2023-08-01,Nong Khai ,east_northeast,0.6282,83060,241225,178871,62354,396230000,256430000,139800000
2023-08-01,Nong Bua Lamphu ,east_northeast,0.39759999999999995,7961,24745,24562,183,19500000,19340000,160000
2023-08-01,Udon Thani ,east_northeast,0.6265,130688,326497,253701,72796,728590000,478320000,250270000
2023-08-01,Chaiyaphum ,east_northeast,0.6918000000000001,79864,170390,169888,502,229710000,228510000,1200000
2023-08-01,Nakhon Ratchasima ,east_northeast,0.6944,391406,668850,655277,13573,1307730000,1263460000,44270000
2023-08-01,Buriram ,east_northeast,0.7009000000000001,135836,265908,263426,2482,535780000,529420000,6360000
2023-08-01,Mukdahan ,east_northeast,0.37520000000000003,30490,124070,115340,8730,171310000,151810000,19500000
2023-08-01,Yasothon ,east_northeast,0.405,10702,42576,42424,152,40440000,40180000,260000
2023-08-01,Roi Et ,east_northeast,0.4143,25368,58487,57593,894,76720000,74480000,2240000
2023-08-01,Sisaket ,south,0.4996,28870,86827,86451,376,109110000,108150000,960000
2023-08-01,Surin ,east_northeast,0.4622,62037,83000,80899,2101,143600000,139680000,3920000
2023-08-01,Amnat Charoen ,east_northeast,0.33140000000000003,5681,19574,19123,451,22430000,21640000,790000
2023-08-01,Ubon Ratchathani ,east_northeast,0.5297999999999999,96720,240283,238601,1682,435950000,432200000,3750000
2023-09-01,Bangkok,central,0.7381,2555167,4493195,2533330,1959865,59409229999,13133880000,46275350000
2023-09-01,Kanchanaburi ,central,0.5981000000000001,250007,1145830,1117788,28042,2292210000,2201330000,90880000
2023-09-01,Nakhon Pathom ,central,0.4802,71056,301453,297830,3623,387310000,377770000,9540000
2023-09-01,Prachuap Khiri Khan ,central,0.585,374073,795750,757220,38530,3324569999,2874390000,450180000
2023-09-01,Phetchaburi ,central,0.6107,281525,821451,809165,12286,2395660000,2328350000,67310000
2023-09-01,Ratchaburi ,central,0.5025999999999999,71395,183141,174437,8704,277310000,258110000,19200000
2023-09-01,Samut Prakan ,central,0.4877,78359,249714,187164,62550,382500000,277400000,105100000
2023-09-01,Samut Songkhram ,central,0.5239,59905,542880,531451,11429,536210000,520050000,16160000
2023-09-01,Samut Sakhon ,central,0.3898,28212,101913,101286,627,146380000,145030000,1350000
2023-09-01,Chainat ,central,0.46619999999999995,18169,85087,84616,471,125630000,125010000,620000
2023-09-01,Nonthaburi ,central,0.5638000000000001,82145,314787,298347,16440,445660000,419200000,26460000
2023-09-01,Pathum Thani ,central,0.4758,40116,250955,232303,18652,351050000,321970000,29080000
2023-09-01,Phra Nakhon Si Ayutthaya ,central,0.5546,75920,827421,728906,98515,1505710000,1262560000,243150000
2023-09-01,Lopburi ,central,0.4622,55231,331823,330975,848,420570000,419300000,1270000
2023-09-01,Saraburi ,central,0.5091,74037,341559,338389,3170,592420000,587290000,5130000
2023-09-01,Sing Buri ,central,0.49450000000000005,15871,61219,60912,307,84210000,83590000,620000
2023-09-01,Suphan Buri ,central,0.47840000000000005,63552,516280,514144,2136,614750000,611370000,3380000
2023-09-01,Ang Thong ,central,0.44439999999999996,12019,85910,85166,744,110120000,109090000,1030000
2023-09-01,Chanthaburi ,east,0.4953,81224,272926,271651,1275,871140000,868570000,2570000
2023-09-01,Chachoengsao ,east,0.40850000000000003,29352,470647,468993,1654,528400000,526660000,1740000
2023-09-01,Chonburi ,east,0.7424,1194575,1707757,1024234,683523,15905090000,6414080000,9491010000
2023-09-01,Trat ,east,0.41490000000000005,109604,122114,100581,21533,785609999,630800000,154810000
2023-09-01,Nakhon Nayok ,east,0.6084,89866,156623,155731,892,372310000,369350000,2960000
2023-09-01,Prachinburi ,east,0.4238,53640,101029,100379,650,272020000,269610000,2410000
2023-09-01,Rayong ,east,0.6751,235519,389938,330165,59773,1349940000,1186550000,163390000
2023-09-01,Sa Kaeo ,east,0.4743,37357,111490,110001,1489,333800000,329930000,3870000
2023-09-01,Krabi ,south,0.5917,130372,273032,164051,108981,2240710000,1516480000,724230000
2023-09-01,Chumphon ,south,0.5556,91747,132991,130947,2044,336040000,330000000,6040000
2023-09-01,Nakhon Si Thammarat ,south,0.7173,207449,401607,397207,4400,946530000,935170000,11360000
2023-09-01,Phang Nga ,south,0.49979999999999997,57067,217680,79541,138139,1031670000,253140000,778530000
2023-09-01,Phuket ,south,0.6820999999999999,682363,840815,221487,619328,27313200000,1624510000,25688690000
2023-09-01,Ranong ,south,0.505,36405,53466,52157,1309,112510000,108770000,3740000
2023-09-01,Surat Thani ,south,0.7042,390268,600290,348897,251393,4908290000,2056130000,2852160000
2023-09-01,Trang ,south,0.44420000000000004,52701,99814,96493,3321,327590000,317730000,9860000
2023-09-01,Narathiwat ,south,0.6091,36314,62751,30294,32457,155360000,53930000,101430000
2023-09-01,Pattani ,south,0.5518,17644,46003,32651,13352,70260000,64790000,5470000
2023-09-01,Phatthalung ,south,0.6322,42535,119551,117305,2246,117510000,115790000,1720000
2023-09-01,Yala ,south,0.727,78680,143329,87097,56232,305130000,153790000,151340000
2023-09-01,Songkhla ,south,0.7314,255130,436442,261512,174930,2409350000,1328910000,1080440000
2023-09-01,Satun ,south,0.5861,79932,166169,149317,16852,790420000,726820000,63600000
2023-09-01,Chiang Rai ,north,0.6365,308546,432261,388196,44065,3252450000,2761050000,491400000
2023-09-01,Chiang Mai ,north,0.6633,517231,715494,511647,203847,5847559999,3729060000,2118500000
2023-09-01,Nan ,north,0.6481999999999999,75075,104217,103286,931,271479999,266140000,5340000
2023-09-01,Phayao ,north,0.569,37384,72701,69931,2770,166100000,157170000,8930000
2023-09-01,Phrae ,north,0.6039,45275,106320,105057,1263,245860000,242290000,3570000
2023-09-01,Mae Hong Son ,north,0.42579999999999996,76680,86596,70094,16502,438250000,325070000,113180000
2023-09-01,Lampang ,north,0.5476,51698,132946,126668,6278,429100000,397150000,31950000
2023-09-01,Lamphun ,north,0.5206000000000001,20751,99473,95680,3793,135080000,126340000,8740000
2023-09-01,Kamphaeng Phet ,north,0.3329,29497,59729,58103,1626,112330000,108890000,3440000
2023-09-01,Tak ,north,0.5578,114937,149703,146688,3015,484560000,470950000,13610000
2023-09-01,Nakhon Sawan ,north,0.46090000000000003,76316,147711,146537,1174,387790000,383150000,4640000
2023-09-01,Phichit ,north,0.4522,27967,60826,60691,135,102110000,101740000,370000
2023-09-01,Phitsanulok ,north,0.4696,120338,210411,201642,8769,553030000,526700000,26330000
2023-09-01,Phetchabun ,north,0.524,160890,218949,216050,2899,748550000,736950000,11600000
2023-09-01,Sukhothai ,north,0.2863,40512,84122,68779,15343,213180000,164170000,49010000
2023-09-01,Uttaradit ,north,0.41859999999999997,42930,82699,82304,395,146600000,145520000,1080000
2023-09-01,Uthai Thani ,north,0.462,26298,78563,78488,75,130510000,130310000,200000
2023-09-01,Kalasin ,east_northeast,0.4736,21826,60778,59040,1738,80670000,75930000,4740000
2023-09-01,Khon Kaen ,east_northeast,0.5283,144800,297573,290349,7224,839380000,819790000,19590000
2023-09-01,Nakhon Phanom ,east_northeast,0.7686,68016,185816,177948,7868,280390000,259810000,20580000
2023-09-01,Bueng Kan ,east_northeast,0.5478000000000001,34074,76340,74131,2209,103010000,98970000,4040000
2023-09-01,Maha Sarakham ,east_northeast,0.4631,22311,35078,34306,772,41370000,39600000,1770000
2023-09-01,Loei ,east_northeast,0.6648999999999999,105599,179081,176737,2344,373970000,365180000,8790000
2023-09-01,Sakon Nakhon ,east_northeast,0.47950000000000004,51357,129232,128435,797,165720000,163470000,2250000
2023-09-01,Nong Khai ,east_northeast,0.6325,85452,246588,186511,60077,422480000,286210000,136270000
2023-09-01,Nong Bua Lamphu ,east_northeast,0.4078,8193,25453,25283,170,20000000,19850000,150000
2023-09-01,Udon Thani ,east_northeast,0.6441,135044,321399,252330,69069,730400000,489940000,240460000
2023-09-01,Chaiyaphum ,east_northeast,0.611,69103,141329,140912,417,188830000,187780000,1050000
2023-09-01,Nakhon Ratchasima ,east_northeast,0.7229000000000001,405124,692237,677638,14599,1369409999,1321290000,48120000
2023-09-01,Buriram ,east_northeast,0.6764,130801,242476,240169,2307,476480000,470580000,5900000
2023-09-01,Mukdahan ,east_northeast,0.3619,30058,122285,113965,8320,165350000,147240000,18110000
2023-09-01,Yasothon ,east_northeast,0.3875,10067,42094,41953,141,38700000,38460000,240000
2023-09-01,Roi Et ,east_northeast,0.39520000000000005,24298,56139,55324,815,72740000,70750000,1990000
2023-09-01,Sisaket ,south,0.4853,27499,82962,82592,370,102410000,101480000,930000
2023-09-01,Surin ,east_northeast,0.4506,58945,79097,77055,2042,133920000,130160000,3760000
2023-09-01,Amnat Charoen ,east_northeast,0.3283,5448,18864,18429,435,21580000,20820000,760000
2023-09-01,Ubon Ratchathani ,east_northeast,0.49479999999999996,88525,214061,212461,1600,381990000,378480000,3510000
2023-10-01,Bangkok,central,0.721,2525804,4395788,2412172,1983616,61811340000,12897800000,48913540000
2023-10-01,Kanchanaburi ,central,0.6272,259479,1186721,1156338,30383,2553790000,2444540000,109250000
2023-10-01,Nakhon Pathom ,central,0.5686,80030,339018,335331,3687,527940000,517730000,10210000
2023-10-01,Prachuap Khiri Khan ,central,0.6236999999999999,393609,825890,793708,32182,3578560000,3201860000,376700000
2023-10-01,Phetchaburi ,central,0.6442,303680,877599,869193,8406,2724470000,2675700000,48770000
2023-10-01,Ratchaburi ,central,0.5418,79592,198661,191689,6972,342260000,325510000,16750000
2023-10-01,Samut Prakan ,central,0.5123,81915,280117,214185,65932,436060000,320660000,115400000
2023-10-01,Samut Songkhram ,central,0.5645,65613,560030,551536,8494,566330000,552610000,13720000
2023-10-01,Samut Sakhon ,central,0.3796,27154,98508,97964,544,143170000,142040000,1130000
2023-10-01,Chainat ,central,0.5033,19339,92239,91858,381,133400000,132840000,560000
2023-10-01,Nonthaburi ,central,0.5843,87128,303334,287176,16158,446010000,416620000,29390000
2023-10-01,Pathum Thani ,central,0.5092,44541,256635,239231,17404,376070000,347820000,28250000
2023-10-01,Phra Nakhon Si Ayutthaya ,central,0.5872999999999999,83088,858358,762171,96187,1624460000,1383020000,241440000
2023-10-01,Lopburi ,central,0.5091,59300,341485,340732,753,450180000,448960000,1220000
2023-10-01,Saraburi ,central,0.578,83016,399369,392814,6555,709920000,697730000,12190000
2023-10-01,Sing Buri ,central,0.5061,16557,65058,64867,191,96720000,96320000,400000
2023-10-01,Suphan Buri ,central,0.5127,69570,538303,535343,2960,720359999,714800000,5560000
2023-10-01,Ang Thong ,central,0.4267,11271,81045,80399,646,106940000,106010000,930000
2023-10-01,Chanthaburi ,east,0.5024000000000001,85119,275831,274661,1170,881400000,878930000,2470000
2023-10-01,Chachoengsao ,east,0.4339,32205,482857,481315,1542,562060000,560360000,1700000
2023-10-01,Chonburi ,east,0.7693000000000001,1279178,1746421,1088275,658146,16301619999,6842800000,9458820000
2023-10-01,Trat ,east,0.45770000000000005,135075,159165,133844,25321,1005570000,821010000,184560000
2023-10-01,Nakhon Nayok ,east,0.6481999999999999,109713,199670,198917,753,464910000,462260000,2650000
2023-10-01,Prachinburi ,east,0.4329,56626,108086,107491,595,312580000,310380000,2200000
2023-10-01,Rayong ,east,0.636,210678,322052,264378,57674,1221520000,1053760000,167760000
2023-10-01,Sa Kaeo ,east,0.5085000000000001,42728,121985,120602,1383,353470000,349620000,3850000
2023-10-01,Krabi ,south,0.6123,135966,280851,167377,113474,2412540000,1555100000,857440000
2023-10-01,Chumphon ,south,0.5715,95294,137901,135525,2376,374320000,366950000,7370000
2023-10-01,Nakhon Si Thammarat ,south,0.7329000000000001,210277,416198,410646,5552,1081280000,1066890000,14390000
2023-10-01,Phang Nga ,south,0.524,61779,232825,83717,149108,1138860000,275410000,863450000
2023-10-01,Phuket ,south,0.6889,730664,894684,214967,679717,30682510000,1677510000,29005000000
2023-10-01,Ranong ,south,0.5309,39467,59480,57730,1750,127670000,122610000,5060000
2023-10-01,Surat Thani ,south,0.7214,405225,654586,387484,267102,6465460000,2422690000,4042770000
2023-10-01,Trang ,south,0.45130000000000003,55799,104625,100643,3982,356460000,343820000,12640000
2023-10-01,Narathiwat ,south,0.6167,37981,90786,33865,56921,235690000,61520000,174170000
2023-10-01,Pattani ,south,0.5604,18449,51555,36329,15226,85660000,77510000,8150000
2023-10-01,Phatthalung ,south,0.6483,45144,136351,133976,2375,141230000,139350000,1880000
2023-10-01,Yala ,south,0.7392,82622,154544,94511,60033,338720000,174150000,164570000
2023-10-01,Songkhla ,south,0.7452,266787,457075,271388,185687,2784010000,1591040000,1192970000
2023-10-01,Satun ,south,0.6052000000000001,83753,188348,168458,19890,888719999,811420000,77300000
2023-10-01,Chiang Rai ,north,0.7011,344315,483735,429905,53830,3885940000,3263470000,622470000
2023-10-01,Chiang Mai ,north,0.7376,572265,911101,660516,250585,7760450000,4943570000,2816880000
2023-10-01,Nan ,north,0.7265,83433,117521,116484,1037,281600000,275550000,6050000
2023-10-01,Phayao ,north,0.6103999999999999,38863,82544,79088,3456,188450000,179230000,9220000
2023-10-01,Phrae ,north,0.5967,43036,100509,98832,1677,215970000,211700000,4270000
2023-10-01,Mae Hong Son ,north,0.5147999999999999,92834,101067,82988,18079,510940000,389410000,121530000
2023-10-01,Lampang ,north,0.6293,58322,152433,143708,8725,481100000,437870000,43230000
2023-10-01,Lamphun ,north,0.5714,22613,110440,105057,5383,154450000,143470000,10980000
2023-10-01,Kamphaeng Phet ,north,0.3856,32078,69935,67968,1967,136280000,131940000,4340000
2023-10-01,Tak ,north,0.591,123391,163461,160398,3063,546500000,531830000,14670000
2023-10-01,Nakhon Sawan ,north,0.4752,79025,161086,160270,816,405240000,402010000,3230000
2023-10-01,Phichit ,north,0.4387,28749,66022,65910,112,115400000,115100000,300000
2023-10-01,Phitsanulok ,north,0.5028,131572,235984,225291,10693,676630000,639700000,36930000
2023-10-01,Phetchabun ,north,0.5681,176718,230184,226995,3189,790030000,777950000,12080000
2023-10-01,Sukhothai ,north,0.3059,40966,97913,81249,16664,261260000,209050000,52210000
2023-10-01,Uttaradit ,north,0.44229999999999997,44403,85939,85415,524,147760000,146480000,1280000
2023-10-01,Uthai Thani ,north,0.49310000000000004,28653,81859,81772,87,144190000,143980000,210000
2023-10-01,Kalasin ,east_northeast,0.46380000000000005,21522,61223,59561,1662,80980000,76480000,4500000
2023-10-01,Khon Kaen ,east_northeast,0.5504,151443,322308,314789,7519,921070000,899800000,21270000
2023-10-01,Nakhon Phanom ,east_northeast,0.8026000000000001,71998,198738,187685,11053,307080000,278160000,28920000
2023-10-01,Bueng Kan ,east_northeast,0.5592,36063,78942,76434,2508,107660000,103070000,4590000
2023-10-01,Maha Sarakham ,east_northeast,0.4415,21732,34372,33704,668,40080000,38610000,1470000
2023-10-01,Loei ,east_northeast,0.677,108405,182724,180329,2395,397080000,387620000,9460000
2023-10-01,Sakon Nakhon ,east_northeast,0.5105,56557,150700,148899,1801,208220000,203530000,4690000
2023-10-01,Nong Khai ,east_northeast,0.6748000000000001,92746,282823,211433,71390,498360000,336730000,161630000
2023-10-01,Nong Bua Lamphu ,east_northeast,0.4202,8475,27306,27126,180,22340000,22180000,160000
2023-10-01,Udon Thani ,east_northeast,0.6681,143958,403009,317216,85793,873069999,575540000,297530000
2023-10-01,Chaiyaphum ,east_northeast,0.6342,73224,147948,147553,395,200460000,199470000,990000
2023-10-01,Nakhon Ratchasima ,east_northeast,0.7426,429859,717936,702101,15835,1461480000,1408700000,52780000
2023-10-01,Buriram ,east_northeast,0.8712000000000001,196874,434960,430562,4398,934050000,922710000,11340000
2023-10-01,Mukdahan ,east_northeast,0.4078,32462,141525,130797,10728,193940000,170650000,23290000
2023-10-01,Yasothon ,east_northeast,0.4054,10442,43306,43128,178,40490000,40170000,320000
2023-10-01,Roi Et ,east_northeast,0.4092,25466,62454,61530,924,82280000,79870000,2410000
2023-10-01,Sisaket ,south,0.46840000000000004,26470,83815,83471,344,103050000,102190000,860000
2023-10-01,Surin ,east_northeast,0.5071,65693,93421,91175,2246,164579999,160140000,4440000
2023-10-01,Amnat Charoen ,east_northeast,0.3414,5832,20033,19610,423,23000000,22260000,740000
2023-10-01,Ubon Ratchathani ,east_northeast,0.5127,91186,231470,229784,1686,421370000,417620000,3750000
